,date,close_price,trading_buy_count,trading_buy_volume,trading_sell_count,trading_sell_volume,buy_sell_difference,auction_volume,auction_value (1000VND)
0,2022-11-29,11.5,846,1887274,566,1591113,296161,1589500,17847256
1,2022-11-28,10.5,200,642101,93,104014,538087,103700,1080750
2,2022-11-25,9.6,280,1031136,175,290597,740539,289900,2781999
3,2022-11-24,8.8,434,1520313,361,751935,768378,751400,6141733
4,2022-11-23,8.0,314,891007,360,803363,87644,642500,5334003
5,2022-11-22,8.4,456,1316263,372,1138198,178065,1137500,9498125
6,2022-11-21,7.7,349,994127,195,411643,582484,410900,3142859
7,2022-11-18,7.0,470,2164096,396,1395008,769088,1394200,9218785
8,2022-11-17,6.4,312,1329726,219,881422,448304,880900,5605422
9,2022-11-16,5.9,399,1211485,325,957036,254449,956200,4966264
10,2022-11-15,5.4,171,506686,202,732820,-226134,506400,2737122
11,2022-11-14,5.9,189,581995,245,895817,-313822,581500,3504090
12,2022-11-11,6.5,226,1159744,501,1306620,-146876,983000,6636302
13,2022-11-10,6.6,285,490779,263,1095835,-605056,490200,3265869
14,2022-11-09,7.3,285,672369,293,556065,116304,469400,3473532
15,2022-11-08,7.1,327,676810,328,651119,25691,561400,3859041
16,2022-11-07,7.3,247,676616,384,1014514,-337898,675800,5059438
17,2022-11-04,8.1,493,941500,405,1105630,-164130,940500,7806808
18,2022-11-03,9.0,357,596299,310,619274,-22975,446500,4049920
19,2022-11-02,9.3,355,599338,313,476288,123050,322400,2973901
20,2022-11-01,9.2,1127,1833793,669,1820186,13607,1634800,14999077
21,2022-10-31,9.9,197,175318,152,219663,-44345,98400,944710
22,2022-10-28,10.2,184,229558,235,324469,-94911,166700,1726690
23,2022-10-27,10.2,210,288534,191,243300,45234,192900,1870841
24,2022-10-26,9.4,204,226747,204,355450,-128703,181100,1685241
25,2022-10-25,10.0,257,386357,201,385447,910,366900,3441610
26,2022-10-24,9.9,179,204193,146,261607,-57414,204100,2054509
27,2022-10-21,10.9,232,279464,154,331802,-52338,279300,3142209
28,2022-10-20,12.1,136,200267,157,231046,-30779,139400,1694980
29,2022-10-19,12.4,163,312392,141,247030,65362,138100,1726360
30,2022-10-18,12.7,204,357294,289,407660,-50366,260800,3398631
31,2022-10-17,12.3,259,314980,191,353650,-38670,257600,3102560
32,2022-10-14,12.4,266,387648,269,406380,-18732,293700,3583971
33,2022-10-13,11.8,208,333923,263,362423,-28500,251200,2942620
34,2022-10-12,11.4,195,320048,238,297703,22345,239900,2678251
35,2022-10-11,10.8,217,273386,224,393511,-120125,273200,3013380
36,2022-10-10,11.9,334,430715,257,415360,15355,323200,3642428
37,2022-10-07,11.7,403,556434,258,686720,-130286,556300,6641093
38,2022-10-06,12.9,269,262809,172,328419,-65610,201200,2713520
39,2022-10-05,14.2,251,317765,229,327060,-9295,234600,3305209
40,2022-10-04,13.7,226,236375,256,314570,-78195,133700,1851590
41,2022-10-03,13.7,263,265360,224,454990,-189630,265200,3781410
42,2022-09-30,15.2,371,422912,258,486752,-63840,337500,5047221
43,2022-09-29,15.6,212,297223,282,440620,-143397,225100,3625900
44,2022-09-28,16.0,271,282469,226,308700,-26231,173400,2768520
45,2022-09-27,16.2,300,395205,275,379824,15381,268500,4278110
46,2022-09-26,16.0,535,857098,371,971880,-114782,826700,12997270
47,2022-09-23,17.0,443,461128,303,574558,-113430,369200,6367002
48,2022-09-22,17.7,378,433546,260,400924,32622,266300,4597331
49,2022-09-21,17.5,216,217921,202,384000,-166079,117100,2045420
50,2022-09-20,17.7,536,678022,308,459490,218532,344900,5819039
51,2022-09-19,17.1,420,372342,328,546605,-174263,344600,6173261
52,2022-09-16,18.8,413,389328,353,745680,-356352,264900,5034740
53,2022-09-15,19.4,406,458934,318,421687,37247,278000,5425131
54,2022-09-14,19.2,558,654407,324,569263,85144,374400,7183029
55,2022-09-13,19.8,632,852007,335,673110,178897,356500,7106860
56,2022-09-12,20.5,397,585623,406,598233,-12610,330500,6921741
57,2022-09-09,20.0,704,588203,400,622428,-34225,430900,8551878
58,2022-09-08,20.9,898,1113064,595,1485122,-372058,1048100,22412130
59,2022-09-07,23.1,579,992234,447,795680,196554,588700,13277693
60,2022-09-06,22.9,1399,2405528,870,1819824,585704,1698800,40115854
61,2022-09-05,48.0,1367,1323108,913,1270338,52770,807900,39275679
62,2022-08-31,49.5,1254,1133961,958,1647300,-513339,925000,46962648
63,2022-08-30,55.0,1116,1377825,565,943865,433960,682800,34867018
64,2022-08-29,52.2,1532,1284676,810,1604423,-319747,1284500,67676516
65,2022-08-26,58.0,857,1128592,582,758028,370564,596700,33897680
66,2022-08-25,54.7,979,1577105,497,834950,742155,834900,45589422
67,2022-08-24,49.8,844,1867720,203,1362903,504817,1362900,64959753
68,2022-08-23,45.3,313,348919,229,244959,103960,244900,10936250
69,2022-08-22,41.2,201,196007,193,161652,34355,115600,4719050
70,2022-08-19,39.4,66,89316,85,70921,18395,36700,1444180
71,2022-08-18,39.4,88,106006,89,97000,9006,55900,2183710
72,2022-08-17,39.3,60,80487,96,72816,7671,23600,930910
73,2022-08-16,39.3,89,81709,61,53125,28584,21800,857150
74,2022-08-15,39.9,79,62520,66,50400,12120,21500,857820
75,2022-08-12,40.2,68,54100,67,49400,4700,20600,820940
76,2022-08-11,40.0,103,58200,113,86100,-27900,47500,1905610
77,2022-08-10,40.8,95,82000,124,81118,882,40000,1610010
78,2022-08-09,40.0,101,78805,77,70000,8805,30800,1212820
79,2022-08-08,40.5,88,59600,89,54805,4795,33200,1311060
80,2022-08-05,40.0,115,65500,75,51400,14100,28100,1109900
81,2022-08-04,39.9,157,115000,145,139700,-24700,87100,3537860
82,2022-08-03,39.9,101,109408,132,83954,25454,70300,2721180
83,2022-08-02,38.0,139,128807,133,133605,-4798,99600,3755410
84,2022-08-01,37.4,159,147808,159,124459,23349,105100,3866340
85,2022-07-29,35.6,64,62208,109,85554,-23346,38400,1362500
86,2022-07-28,35.2,130,89915,142,113000,-23085,70300,2468000
87,2022-07-27,34.5,42,27808,46,35600,-7792,15200,521320
88,2022-07-26,34.8,71,42057,73,71627,-29570,19700,670770
89,2022-07-25,34.3,80,44110,78,59000,-14890,15800,540350
90,2022-07-22,34.3,61,40808,69,43605,-2797,10200,352270
91,2022-07-21,34.6,99,79409,80,102627,-23218,51300,1791160
92,2022-07-20,35.5,107,87005,95,90357,-3352,49300,1726940
93,2022-07-19,34.4,126,75206,77,61670,13536,35600,1223970
94,2022-07-18,35.9,65,40705,46,36065,4640,17600,623160
95,2022-07-15,35.8,100,83130,77,65570,17560,37900,1351050
96,2022-07-14,36.0,81,59111,79,53100,6011,30100,1067530
97,2022-07-13,36.4,110,97025,117,128452,-31427,79300,2861770
98,2022-07-12,36.6,123,99505,122,84507,14998,67700,2392480
99,2022-07-11,34.5,65,54111,67,70004,-15893,23100,789330
100,2022-07-08,34.5,98,99810,70,85100,14710,34900,1182200
101,2022-07-07,33.2,72,50805,52,38000,12805,18100,611160
102,2022-07-06,34.9,96,64653,87,40452,24201,22100,755960
103,2022-07-05,35.8,58,62702,70,57200,5502,29200,1026240
104,2022-07-04,36.0,68,50002,75,56406,-6404,24900,900060
105,2022-07-01,37.0,95,66502,97,50205,16297,37600,1286740
106,2022-06-30,34.5,84,71800,76,92900,-21100,60700,2035900
107,2022-06-29,36.3,178,1112200,126,1083805,28395,97200,38477470
108,2022-06-28,36.3,127,136902,167,81306,55596,76700,2703280
109,2022-06-27,33.0,100,98302,107,81800,16502,59000,1910450
110,2022-06-24,32.5,83,70800,94,65200,5600,29100,945180
111,2022-06-23,33.0,98,87500,121,81700,5800,51900,1643550
112,2022-06-22,31.5,159,141005,170,114500,26505,97600,2934010
113,2022-06-21,29.1,123,89304,155,187200,-97896,89300,2623010
114,2022-06-20,32.3,130,124500,125,199900,-75400,124500,4066440
115,2022-06-17,35.8,171,131200,132,186600,-55400,131200,4751300
116,2022-06-16,39.7,71,44600,87,54300,-9700,21800,878440
117,2022-06-15,40.2,121,62500,116,82900,-20400,49600,1920740
118,2022-06-14,41.0,109,46900,66,42405,4495,27700,1146810
119,2022-06-13,41.9,90,38702,93,95300,-56598,26100,1114070
120,2022-06-10,44.5,106,54702,81,120109,-65407,42300,1864090
121,2022-06-09,44.6,81,40402,78,99809,-59407,20100,901250
122,2022-06-08,44.9,106,75002,88,103900,-28898,60400,2719400
123,2022-06-07,44.5,115,52800,105,84700,-31900,28700,1271610
124,2022-06-06,45.3,117,90698,104,132900,-42202,52000,2369190
125,2022-06-03,45.5,187,82098,98,69800,12298,41400,1869740
126,2022-06-02,46.8,74,61428,81,99121,-37693,32600,1531330
127,2022-06-01,47.9,123,42607,74,85200,-42593,27900,1314570
128,2022-05-31,48.0,131,50627,112,117200,-66573,36900,1779450
129,2022-05-30,49.0,94,66923,123,153009,-86086,47400,2331430
130,2022-05-27,49.2,147,158327,202,161400,-3073,103600,5084060
131,2022-05-26,48.4,183,132527,122,145200,-12673,80800,3896650
132,2022-05-25,48.5,159,131811,211,157500,-25689,89800,4351050
133,2022-05-24,47.5,120,126625,90,124713,1912,93400,4362820
134,2022-05-23,47.5,116,82001,138,103009,-21008,65300,3110570
135,2022-05-20,48.1,149,105829,144,145100,-39271,84100,4038400
136,2022-05-19,48.2,146,71430,170,116300,-44870,51600,2455640
137,2022-05-18,48.2,185,218510,220,237309,-18799,173200,8356730
138,2022-05-17,48.0,150,131830,217,148000,-16170,90700,4214970
139,2022-05-16,44.4,125,91640,201,126200,-34560,62000,2852890
140,2022-05-13,44.0,198,127600,200,122671,4929,75700,3287440
141,2022-05-12,43.5,139,69900,127,87871,-17971,45100,2036780
142,2022-05-11,47.7,147,87022,189,110595,-23573,66600,3164810
143,2022-05-10,44.7,173,84904,166,88395,-3491,53200,2305630
144,2022-05-09,42.5,235,163809,193,153280,10529,128100,5312030
145,2022-05-06,45.2,148,93000,112,81525,11475,48000,2202410
146,2022-05-05,48.0,122,99595,122,113500,-13905,52600,2545900
147,2022-05-04,49.1,260,133602,164,202100,-68498,118600,5950010
148,2022-04-29,54.0,194,117703,165,110200,7503,74400,3957900
149,2022-04-28,53.1,216,118715,204,199300,-80585,94600,5082160
150,2022-04-27,53.0,236,156666,217,135171,21495,102800,5165570
151,2022-04-26,48.4,244,218301,231,159770,58531,159700,6958220
152,2022-04-25,44.0,144,192400,236,254800,-62400,177000,7894641
153,2022-04-22,45.4,331,450600,320,426200,24400,372500,17251589
154,2022-04-21,45.4,79,32060,157,450500,-418440,32000,1452840
155,2022-04-20,50.4,176,308137,244,267800,40337,227000,11310450
156,2022-04-19,49.6,341,206476,258,267048,-60572,206300,10553400
157,2022-04-18,55.1,363,245139,189,299424,-54285,245100,13766880
158,2022-04-15,61.2,246,133828,146,166760,-32932,75200,4581250
159,2022-04-14,63.3,111,43625,117,98810,-55185,25500,1632000
160,2022-04-13,66.1,211,147570,148,78200,69370,75000,4651640
161,2022-04-12,60.1,205,94276,162,115000,-20724,78200,4863000
162,2022-04-08,64.0,179,95902,144,163500,-67598,71000,4621960
163,2022-04-07,65.1,264,147736,192,169400,-21664,95300,6299120
164,2022-04-06,67.0,431,275439,252,251321,24118,175300,11859750
165,2022-04-05,70.0,233,219134,218,179800,39334,71100,4965150
166,2022-04-04,71.0,234,204037,248,253450,-49413,105500,7468510
167,2022-04-01,71.9,287,242713,242,292320,-49607,134900,9557000
168,2022-03-31,72.4,276,480171,528,472610,7561,360000,25647170
169,2022-03-30,70.6,287,315701,294,283604,32097,214600,14772000
170,2022-03-29,69.6,258,341822,247,370678,-28856,192500,13477870
171,2022-03-28,70.0,423,293809,244,344567,-50758,183200,12651140
172,2022-03-25,71.1,217,676241,274,247645,428596,136800,9641490
173,2022-03-24,70.0,268,365677,243,238604,127073,99900,6987490
174,2022-03-23,71.0,219,234239,219,165004,69235,85400,5918000
175,2022-03-22,69.8,167,178319,224,209169,-30850,127700,9052740
176,2022-03-21,71.1,222,312566,258,263501,49065,163000,11408000
177,2022-03-18,69.5,106,215502,200,177000,38502,86900,6012020
178,2022-03-17,69.0,140,269097,181,242304,26793,152000,10485000
179,2022-03-16,69.0,109,162965,159,151319,11646,92700,6393870
180,2022-03-15,67.7,171,212867,194,165403,47464,116700,7852960
181,2022-03-14,65.9,238,242247,213,183606,58641,144300,9498200
182,2022-03-11,66.0,355,278869,247,222650,56219,173400,11725960
183,2022-03-10,68.9,248,146758,178,243200,-96442,101900,7052470
184,2022-03-09,68.7,357,198463,254,249219,-50756,142400,9849650
185,2022-03-08,70.4,329,248523,212,250905,-2382,160300,11411621
186,2022-03-07,72.1,461,325997,315,355200,-29203,241000,17669561
187,2022-03-04,73.6,365,333884,333,318961,14923,240500,17697269
188,2022-03-03,73.0,353,293426,270,274018,19408,230500,16731820
189,2022-03-02,73.6,321,324964,322,274706,50258,164600,12090970
190,2022-03-01,73.9,223,572009,244,196300,375709,118600,8663290
191,2022-02-28,71.8,516,342407,308,287962,54445,202600,14346491
192,2022-02-25,71.8,1308,850748,396,874136,-23388,728300,53747032
193,2022-02-24,76.0,460,320339,413,418132,-97793,235100,18007720
194,2022-02-23,79.0,370,369563,400,442970,-73407,269500,21326850
195,2022-02-22,78.5,540,436689,324,326185,110504,253000,19356309
196,2022-02-21,78.5,382,441392,361,376344,65048,262400,20762080
197,2022-02-18,77.9,313,243747,261,182549,61198,109400,8463850
198,2022-02-17,77.2,389,274214,347,331738,-57524,189300,14760340
199,2022-02-16,78.0,601,1142813,473,891291,251522,811700,60995000
200,2022-02-15,72.5,207,194386,282,211610,-17224,106100,7513000
201,2022-02-14,70.0,221,222491,329,273624,-51133,142100,10029230
202,2022-02-11,69.8,277,286881,338,291728,-4847,203100,13956010
203,2022-02-10,66.5,176,172292,282,205251,-32959,109300,7314351
204,2022-02-09,64.0,123,101475,121,76061,25414,45100,2867540
205,2022-02-08,63.7,115,101722,120,85600,16122,56800,3629680
206,2022-02-07,65.3,127,56796,137,76076,-19280,35500,2304010
207,2022-01-28,63.3,148,106149,168,81059,25090,65200,4036230
208,2022-01-27,60.4,254,190754,97,118160,72594,91500,5490530
209,2022-01-26,61.9,189,170004,151,174283,-4279,106400,6641790
210,2022-01-25,62.8,195,157779,162,103258,54521,67300,4150410
211,2022-01-24,61.2,197,111623,213,225303,-113680,111500,7138000
212,2022-01-21,68.0,266,453845,308,406797,47048,253500,17517261
213,2022-01-20,65.6,255,433147,197,194596,238551,194500,12239080
214,2022-01-19,59.7,264,213012,155,161437,51575,127800,7544290
215,2022-01-18,61.0,215,202702,160,200721,1981,153200,9336491
216,2022-01-17,62.0,154,142100,165,139496,2604,89700,5780020
217,2022-01-14,64.9,225,202301,203,154496,47805,116600,7231080
218,2022-01-13,60.1,213,147348,174,145197,2151,103800,6445000
219,2022-01-12,63.6,368,277763,188,217200,60563,178600,11510000
220,2022-01-11,67.3,189,149298,198,171754,-22456,101200,6911000
221,2022-01-10,68.8,231,166434,244,213937,-47503,125100,8709000
222,2022-01-07,68.1,282,158568,191,140026,18542,113000,7762000
223,2022-01-06,67.0,633,329918,213,305319,24599,227700,15344000
224,2022-01-05,71.0,475,318960,260,363792,-44832,229800,16747000
225,2022-01-04,76.0,177,223272,242,232331,-9059,136500,10390350
226,2021-12-31,76.0,240,310680,256,285624,25056,203900,15547000
227,2021-12-30,76.8,198,281751,297,288197,-6446,115800,9013330
228,2021-12-29,78.0,309,386478,360,367836,18642,271300,20817780
229,2021-12-28,76.3,438,506370,457,477979,28391,374800,29087400
230,2021-12-27,73.7,191,442379,129,287526,154853,287500,21183000
231,2021-12-24,67.0,481,909813,365,562851,346962,524800,31857000
232,2021-12-23,62.1,568,475628,443,764855,-289227,475400,29822000
233,2021-12-22,68.9,950,581959,507,676866,-94907,580600,41147000
234,2021-12-21,76.5,395,248193,335,260833,-12640,172400,13262000
235,2021-12-20,78.0,314,240093,220,223530,16563,162400,12395000
236,2021-12-17,78.9,269,383440,321,404379,-20939,287000,23104000
237,2021-12-16,81.0,392,451885,303,359647,92238,300000,24240000
238,2021-12-15,78.2,222,411206,251,276556,134650,203600,15917000
239,2021-12-14,77.1,246,166317,221,176226,-9909,111000,8715000
240,2021-12-13,81.8,325,327401,265,328822,-1421,241000,19441000
241,2021-12-10,83.0,135,204381,232,231150,-26769,136500,11372000
242,2021-12-09,83.0,209,328851,334,313700,15151,199100,16174000
243,2021-12-08,77.4,178,235240,279,227200,8040,185800,14274000
244,2021-12-07,75.4,250,401390,403,341900,59490,257300,19127000
245,2021-12-06,73.8,511,408940,418,508200,-99260,393800,29598000
246,2021-12-03,82.0,385,201320,277,269900,-68580,152800,12759000
247,2021-12-02,83.5,383,233794,338,368908,-135114,172900,15053000
248,2021-12-01,91.5,285,253503,318,245299,8204,170500,15049000
249,2021-11-30,87.0,326,204360,252,232300,-27940,149800,13346670
250,2021-11-29,87.5,743,594323,406,520458,73865,515700,42646000
251,2021-11-26,80.0,693,337053,449,377677,-40624,269500,22548000
252,2021-11-25,87.1,546,341408,335,380450,-39042,244800,21395000
253,2021-11-24,90.2,317,188407,286,291112,-102705,147900,13562000
254,2021-11-23,93.0,397,306971,253,240900,66071,208000,18306000
255,2021-11-22,92.0,503,530570,488,676060,-145490,480500,45699000
256,2021-11-19,98.0,731,616646,603,792835,-176189,481100,56419200
257,2021-11-18,98.3,695,558010,383,605000,-46990,340200,43544000
258,2021-11-17,99.0,556,473454,358,573684,-100230,300500,39923000
259,2021-11-16,98.1,589,430804,303,499260,-68456,255900,35528000
260,2021-11-15,102.0,767,829179,545,800199,28980,583200,69169000
261,2021-11-12,95.5,554,435846,350,534110,-98264,292000,38104000
262,2021-11-11,98.0,442,413039,378,494762,-81723,245400,34483000
263,2021-11-10,99.8,703,529394,426,557342,-27948,454300,44341000
264,2021-11-09,100.5,467,404736,367,430120,-25384,223500,32084000
265,2021-11-08,100.5,901,605273,477,629900,-24627,470600,48139000
266,2021-11-05,100.3,812,948816,504,827486,121330,821000,82108000
267,2021-11-04,91.3,578,794096,360,497220,296876,497100,43888000
268,2021-11-03,83.0,853,651639,540,748850,-97211,603800,55652000
269,2021-11-02,90.0,664,575008,208,406668,168340,406600,35114000
270,2021-11-01,81.9,509,569267,276,442950,126317,442900,35403000
271,2021-10-29,74.5,344,596100,297,522400,73700,443600,32683000
272,2021-10-28,69.9,336,433300,238,407500,25800,304800,20678000
273,2021-10-27,66.2,318,307100,246,354900,-47800,184600,12257000
274,2021-10-26,66.0,749,600500,438,612800,-12300,490800,32567000
275,2021-10-25,65.7,446,611500,241,411500,200000,411500,26691000
276,2021-10-22,59.8,374,411900,208,379100,32800,288700,16800000
277,2021-10-21,56.0,230,238200,145,244400,-6200,132000,7389000
278,2021-10-20,55.6,196,259800,212,257600,2200,201700,11204000
279,2021-10-19,55.0,344,423400,235,489700,-66300,283500,15472000
280,2021-10-18,53.8,516,618500,405,520600,97900,473300,24759000
281,2021-10-15,49.4,244,416100,235,393800,22300,253500,59527000
282,2021-10-14,49.2,187,498200,200,369000,129200,241100,11815000
283,2021-10-13,48.0,478,622300,277,626800,-4500,449500,43294000
284,2021-10-12,49.8,256,518100,239,458400,59700,260100,12923000
285,2021-10-11,49.5,305,325600,204,265000,60600,183200,9031000
286,2021-10-08,49.1,336,480200,262,412500,67700,267000,13171000
287,2021-10-07,48.0,371,448800,163,316400,132400,254700,12085000
288,2021-10-06,48.0,293,415800,197,254200,161600,190800,9061000
289,2021-10-05,48.0,243,418900,281,457900,-39000,266500,12836000
290,2021-10-04,47.3,331,513800,324,415000,98800,357300,16738000
291,2021-10-01,46.3,344,514200,297,402900,111300,297400,14314000
292,2021-09-30,45.0,504,427500,274,537700,-110200,339400,15455000
293,2021-09-29,46.3,292,350800,249,440000,-89200,283300,13226000
294,2021-09-28,45.1,467,1118600,551,987700,130900,987700,50224600
295,2021-09-27,41.0,365,694400,435,801100,-106700,601000,43270000
296,2021-09-24,40.5,324,614700,368,677200,-62500,482700,64599304
297,2021-09-23,40.5,333,631400,412,756800,-125400,562100,40007000
298,2021-09-22,42.0,651,840900,340,699300,141600,623800,40414000
299,2021-09-21,40.0,667,862200,332,683800,178400,629700,26161000
300,2021-09-20,38.3,1464,1483100,524,1513900,-30800,1309100,53048000
301,2021-09-17,40.5,601,905700,345,630300,275400,630300,49269600
302,2021-09-16,36.9,572,833000,329,600000,233000,600000,21758000
303,2021-09-15,33.6,446,692300,256,714400,-22100,467600,15712000
304,2021-09-14,33.8,1126,1475700,647,1364900,110800,1180800,39452000
305,2021-09-13,32.2,656,1267900,377,688500,579400,688500,23490000
306,2021-09-10,29.3,95,1410700,54,99400,1311300,99400,2912000
307,2021-09-09,26.7,254,1791200,146,266000,1525200,266000,293821000
308,2021-09-08,24.3,1783,2014600,1024,2087400,-72800,1869800,46670000
309,2021-09-07,23.9,483,601900,277,640100,-38200,506600,12120000
310,2021-09-06,23.7,512,788900,294,771900,17000,536800,13044000
311,2021-09-01,24.2,512,739900,294,641000,98900,537000,12452000
312,2021-08-31,22.5,267,335100,153,458600,-123500,280200,6329000
313,2021-08-30,22.6,407,615500,234,422400,193100,427200,9406000
314,2021-08-27,20.6,45,138800,26,125600,13200,47100,955000
315,2021-08-26,20.1,68,178800,39,146100,32700,71500,1431000
316,2021-08-25,20.1,39,124700,22,114200,10500,40900,823000
317,2021-08-24,20.1,106,186300,61,229000,-42700,111400,2269000
318,2021-08-23,20.0,120,271600,69,153100,118500,125500,2476000
319,2021-08-20,19.5,127,212000,73,241900,-29900,133000,2710000
320,2021-08-19,21.2,50,115500,28,126500,-11000,52000,1098000
321,2021-08-18,21.2,121,204900,70,229100,-24200,127100,2723000
322,2021-08-17,20.6,117,200400,67,240600,-40200,122500,2489000
323,2021-08-16,20.9,208,403700,119,256600,147100,218100,4290000
324,2021-08-13,19.2,52,104100,30,125700,-21600,54100,1030000
325,2021-08-12,19.0,83,151400,47,414100,-262700,86700,1675000
326,2021-08-11,18.9,102,171200,58,184900,-13700,106700,2003000
327,2021-08-10,19.5,60,132700,34,199900,-67200,62400,1197000
328,2021-08-09,19.6,116,153900,67,183400,-29500,122000,2440000
329,2021-08-06,18.7,131,255800,75,137400,118400,137400,2526000
330,2021-08-05,17.0,103,217400,59,173400,44000,107700,1816000
331,2021-08-04,17.0,83,173100,48,154300,18800,87100,1465000
332,2021-08-03,17.1,62,135700,36,101500,34200,66500,1121000
333,2021-08-02,17.0,19,117700,11,99600,18100,20200,338000
334,2021-07-30,17.1,37,98700,22,70800,27900,39300,668000
335,2021-07-29,17.0,13,112400,8,76000,36400,14000,240000
336,2021-07-28,17.0,22,90500,13,51500,39000,23500,398000
337,2021-07-27,17.4,13,97900,7,47000,50900,13200,226000
338,2021-07-26,17.1,35,162500,20,69500,93000,36300,613000
339,2021-07-23,16.8,34,107100,20,72500,34600,36000,617000
340,2021-07-22,17.5,32,139500,18,55800,83700,33600,579000
341,2021-07-21,16.9,27,154600,15,92300,62300,28200,479000
342,2021-07-20,17.3,63,129100,36,127400,1700,65700,1086000
343,2021-07-19,17.3,42,58900,24,73600,-14700,44500,769000
344,2021-07-16,18.0,5,56400,3,178300,-121900,5600,101000
345,2021-07-15,18.0,14,57000,8,46200,10800,14900,267000
346,2021-07-14,18.0,58,106800,33,95700,11100,60700,1088000
347,2021-07-13,18.0,50,79800,29,103600,-23800,52600,937000
348,2021-07-12,17.8,97,112400,56,187700,-75300,102000,1817000
349,2021-07-09,19.5,32,74800,18,66000,8800,33500,645000
350,2021-07-08,19.5,16,46000,9,72400,-26400,16800,324000
351,2021-07-07,19.5,238,324000,137,300400,23600,249500,4768000
352,2021-07-06,19.5,220,248800,126,315500,-66700,230600,4482000
353,2021-07-05,20.0,229,318900,131,284500,34400,239900,4696000
354,2021-07-02,20.0,102,224800,58,198600,26200,106800,2120000
355,2021-07-01,20.0,107,223600,61,197700,25900,111800,2239000
356,2021-06-30,20.7,55,137400,32,84800,52600,57800,1174000
357,2021-06-29,20.4,89,254500,51,141500,113000,93300,1890000
358,2021-06-28,20.3,89,157200,51,173400,-16200,93600,1901000
359,2021-06-25,21.4,106,178200,61,197900,-19700,111300,2280000
360,2021-06-24,21.8,46,87400,26,116800,-29400,48300,1035000
361,2021-06-23,21.8,16,31400,9,69700,-38300,17200,370000
362,2021-06-22,21.8,67,109900,39,132900,-23000,70500,1519000
363,2021-06-21,21.9,31,42200,18,120300,-78100,32100,705000
364,2021-06-18,22.3,70,124000,40,160100,-36100,73500,1865170
365,2021-06-17,22.3,31,75900,18,88900,-13000,32500,715000
366,2021-06-16,21.4,70,103000,40,127700,-24700,72900,1565000
367,2021-06-15,21.8,106,164200,61,206000,-41800,111000,2404000
368,2021-06-14,22.0,76,145300,43,139400,5900,79200,1752000
369,2021-06-11,22.3,108,157800,62,190100,-32300,113000,2479000
370,2021-06-10,22.3,97,139500,56,175900,-36400,101800,2227000
371,2021-06-09,22.3,96,157600,55,169700,-12100,100700,2227000
372,2021-06-08,22.5,207,280400,119,352200,-71800,216700,4982000
373,2021-06-07,22.9,150,215700,86,260300,-44600,157300,3558000
374,2021-06-04,23.5,155,260000,89,246900,13100,162800,3653000
375,2021-06-03,22.7,104,181700,60,200300,-18600,109000,2492000
376,2021-06-02,22.3,275,721100,158,325200,395900,287900,6372000
377,2021-06-01,20.6,285,648500,164,299200,349300,299200,5503000
378,2021-05-31,18.8,174,227900,100,233300,-5400,182300,3516000
379,2021-05-28,20.4,207,322600,119,265300,57300,216900,4439000
380,2021-05-27,21.4,124,226400,71,167600,58800,129800,2837000
381,2021-05-26,22.3,153,189000,88,213000,-24000,160000,3527000
382,2021-05-25,23.3,10,39800,6,37100,2700,10700,246000
383,2021-05-24,23.1,141,201000,81,180500,20500,147700,3327000
384,2021-05-21,22.4,222,258800,128,296100,-37300,233000,5187000
385,2021-05-20,22.9,41,70300,23,122800,-52500,42900,986000
386,2021-05-19,23.3,248,304000,143,309500,-5500,260500,6049280
387,2021-05-18,24.0,7,70000,4,57300,12700,7600,181410
388,2021-05-17,24.4,98,380000,56,141100,238900,102700,2456010
389,2021-05-14,23.9,174,297400,100,227800,69600,182400,4349170
390,2021-05-13,24.5,151,280200,86,217200,63000,157900,3824100
391,2021-05-12,25.4,34,108200,19,95500,12700,35400,870170
392,2021-05-11,25.0,57,113700,33,101900,11800,60200,1520560
393,2021-05-10,23.7,84,133300,48,114700,18600,87900,2098920
394,2021-05-07,24.3,57,105200,33,138900,-33700,59700,1474530
395,2021-05-06,25.1,156,222900,89,233700,-10800,163400,4115950
396,2021-05-05,25.7,410,590600,235,521000,69600,429600,10976380
397,2021-05-04,27.3,81,160000,47,142300,17700,85600,2303010
398,2021-04-29,27.4,76,124700,43,107000,17700,79400,2170580
399,2021-04-28,27.8,79,178500,46,134500,44000,83200,2240310
400,2021-04-27,28.2,62,115900,36,196400,-80500,65300,1805430
401,2021-04-26,28.2,218,242100,125,298900,-56800,228200,6463940
402,2021-04-23,29.3,52,189900,30,109300,80600,54600,1599990
403,2021-04-22,29.3,149,215800,85,198500,17300,155900,4667670
404,2021-04-20,29.4,71,128000,41,136400,-8400,74600,3525220
405,2021-04-19,28.6,93,144300,54,139100,5200,98000,2777040
406,2021-04-16,28.5,122,150600,70,168400,-17800,128100,3588530
407,2021-04-15,29.0,201,328000,115,249900,78100,210900,6066830
408,2021-04-14,28.3,74,171600,43,106800,64800,77800,2142940
409,2021-04-13,27.6,254,305000,146,345700,-40700,266300,7260310
410,2021-04-12,27.8,77,192800,44,145700,47100,80800,2211100
411,2021-04-09,27.7,85,217200,49,127900,89300,88800,2425420
412,2021-04-08,27.8,49,146100,28,129700,16400,51700,1439750
413,2021-04-07,27.5,341,488600,196,494100,-5500,357500,9720360
414,2021-04-06,26.0,302,412600,173,393100,19500,316800,8054310
415,2021-04-05,24.6,43,67300,24,104000,-36700,44600,1101880
416,2021-04-02,24.8,90,126000,52,171700,-45700,94400,2356730
417,2021-04-01,24.5,63,85900,36,107800,-21900,66200,1600030
418,2021-03-31,24.0,82,111800,47,125600,-13800,86100,2042880
419,2021-03-30,23.7,52,77400,30,71400,6000,54400,1291990
420,2021-03-29,23.7,34,55100,20,58800,-3700,36100,850790
421,2021-03-26,23.3,129,218200,74,186700,31500,135200,3068720
422,2021-03-25,23.0,57,108200,33,105300,2900,60200,1389670
423,2021-03-24,23.7,164,246600,94,284100,-37500,171800,4000500
424,2021-03-23,23.7,175,222900,100,287600,-64700,183300,4318380
425,2021-03-22,24.5,52,88000,30,182300,-94300,54500,1331730
426,2021-03-19,25.0,125,198600,72,172800,25800,131500,3259470
427,2021-03-18,25.1,67,121200,38,162000,-40800,69900,1745600
428,2021-03-17,24.9,157,263900,90,242100,21800,164600,4075950
429,2021-03-16,24.0,135,191000,78,205100,-14100,141700,3422740
430,2021-03-15,24.3,231,305100,132,317400,-12300,241800,5842230
431,2021-03-12,24.0,87,194400,50,186500,7900,90800,2168900
432,2021-03-11,24.0,68,145900,39,133500,12400,71500,1705890
433,2021-03-10,23.6,230,474300,132,614300,-140000,241100,5691570
434,2021-03-09,23.2,545,696200,313,656000,40200,571500,13258030
435,2021-03-08,24.2,183,265700,105,267400,-1700,192000,4631290
436,2021-03-05,24.0,304,450000,174,409100,40900,318700,7427630
437,2021-03-04,22.4,147,223600,84,204900,18700,154300,3385830
438,2021-03-03,22.4,189,230800,108,338000,-107200,198100,4480620
439,2021-03-02,22.0,734,944500,421,769700,174800,769700,16608660
440,2021-03-01,20.0,148,196700,85,214100,-17400,155400,3065910
441,2021-02-26,19.9,60,75900,34,151000,-75100,63000,1255450
442,2021-02-25,20.3,48,59800,28,176000,-116200,50700,1017620
443,2021-02-24,19.9,73,85800,42,142800,-57000,76900,1543390
444,2021-02-23,20.5,83,97300,48,177800,-80500,87100,1782380
445,2021-02-22,20.4,135,180700,78,230600,-49900,141800,2861520
446,2021-02-19,19.4,54,96200,31,85300,10900,56500,1076160
447,2021-02-18,19.2,112,164600,64,171900,-7300,117000,2226210
448,2021-02-17,19.0,45,74800,26,99900,-25100,46700,881740
449,2021-02-09,18.9,36,124400,21,63400,61000,38200,698090
450,2021-02-08,18.3,78,136100,45,133100,3000,81800,1464990
451,2021-02-05,18.8,58,119900,33,116600,3300,61100,1135530
452,2021-02-04,18.0,45,64300,26,148300,-84000,47500,878560
453,2021-02-03,18.5,136,180700,78,142800,37900,142800,2583090
454,2021-02-02,16.9,59,109700,34,65400,44300,61600,994830
455,2021-02-01,15.4,225,272200,129,310000,-37800,235600,3701930
456,2021-01-29,16.9,272,320000,156,360200,-40200,285300,4687500
457,2021-01-28,17.1,141,147700,81,394100,-246400,147700,2528530
458,2021-01-27,19.0,158,172100,91,226500,-54400,165400,3097490
459,2021-01-26,19.3,284,321500,163,407700,-86200,298100,6137170
460,2021-01-25,21.3,119,177600,69,258700,-81100,125300,2660670
461,2021-01-22,20.8,289,429800,166,486600,-56800,303300,6199070
462,2021-01-21,20.4,110,174400,63,224300,-49900,114900,2319440
463,2021-01-20,20.9,240,304100,138,342600,-38500,251500,5204340
464,2021-01-19,19.5,542,685100,311,574800,110300,568100,10589690
465,2021-01-18,17.8,224,304200,129,273100,31100,236900,4121960
466,2021-01-15,16.2,106,170300,61,150900,19400,110800,1818180
467,2021-01-14,15.9,288,364500,165,358900,5600,302100,4594180
468,2021-01-13,15.0,193,294800,111,312600,-17800,202900,2996020
469,2021-01-12,15.0,208,254000,119,311800,-57800,218200,3270390
470,2021-01-11,14.7,406,568600,233,425700,142900,425700,5956640
471,2021-01-08,13.4,277,367400,159,505200,-137800,290700,3848250
472,2021-01-07,13.7,206,280800,118,365200,-84400,215600,2944240
473,2021-01-06,13.8,305,400100,175,424300,-24200,319700,4440690
474,2021-01-05,13.8,166,227500,95,320700,-93200,173700,2406490
475,2021-01-04,13.9,187,283700,107,320600,-36900,197100,2730740
476,2020-12-31,14.0,188,283200,108,346100,-62900,196800,2715180
477,2020-12-30,13.5,221,420200,127,312700,107500,231900,2959470
478,2020-12-29,12.6,451,663600,259,630300,33300,473500,6185080
479,2020-12-28,12.6,1034,1433400,594,1084300,349100,1084300,13583690
480,2020-12-25,11.5,978,1067700,562,1196800,-129100,1025800,11792370
481,2020-12-24,10.5,133,368000,77,139900,228100,139900,1468950
482,2020-12-23,9.6,520,756600,299,545600,211000,545600,4951820
483,2020-12-22,8.8,72,82600,41,307300,-224700,75500,681190
484,2020-12-21,9.5,4,9600,3,173000,-163400,4600,43700
485,2020-12-18,9.5,0,13400,66,168800,-155400,0,0
486,2020-12-17,9.5,2,36000,1,119600,-83600,2400,22800
487,2020-12-16,9.4,2,21400,1,120200,-98800,2600,24620
488,2020-12-15,9.5,0,10800,88,225100,-214300,0,0
489,2020-12-14,9.5,0,2200,107,272300,-270100,300,3000
490,2020-12-11,9.2,1,20800,1,272900,-252100,1200,11320
491,2020-12-10,9.4,1,14200,1,275400,-261200,1000,9400
492,2020-12-09,9.4,6,21800,4,177200,-155400,6800,63130
493,2020-12-08,9.2,1,13300,86,223200,-209900,900,8520
494,2020-12-07,9.5,4,6374,2,6058,316,4200,39970
495,2020-12-04,8.8,1,1669,1,1587,82,1100,10380
496,2020-12-03,9.5,7,10623,4,10097,526,7000,66500
497,2020-12-02,9.5,8,12292,5,11684,608,8100,76950
498,2020-12-01,9.5,9,15024,6,14280,744,9900,94090
499,2020-11-30,9.5,0,455,0,433,22,300,2730
500,2020-11-27,9.4,6,9560,4,9088,472,6300,60150
501,2020-11-26,9.4,3,4401,2,4183,218,2900,27340
502,2020-11-25,9.2,1,1821,1,1731,90,1200,10820
503,2020-11-24,9.2,1,1821,1,1731,90,1200,11040
504,2020-11-23,9.1,0,607,0,577,30,400,3740
505,2020-11-20,9.6,0,607,0,577,30,400,3690
506,2020-11-19,9.6,0,152,0,144,8,100,960
507,2020-11-18,9.1,1,1669,1,1587,82,1100,10010
508,2020-11-17,9.6,2,3946,1,3750,196,2600,23760
509,2020-11-16,9.1,0,152,0,144,8,100,910
510,2020-11-13,9.7,1,1062,0,1010,52,700,6680
511,2020-11-12,9.3,1,1518,1,1442,76,1000,9300
512,2020-11-11,9.3,0,0,0,0,0,0,0
513,2020-11-10,9.3,0,0,0,0,0,0,0
514,2020-11-09,9.3,0,3600,0,240400,-236800,2400,22430
515,2020-11-06,9.8,0,2700,0,150700,-148000,100,980
516,2020-11-05,9.1,0,1400,0,101400,-100000,100,910
517,2020-11-04,9.0,0,600,0,200,400,200,1870
518,2020-11-03,9.8,0,1900,0,1100,800,1100,10690
519,2020-11-02,9.8,0,1000,0,200,800,200,1880
520,2020-10-30,9.8,0,6300,0,300,6000,300,2860
521,2020-10-29,9.8,0,3800,0,172800,-169000,100,980
522,2020-10-28,9.0,0,11000,0,272300,-261300,200,1860
523,2020-10-27,8.9,0,14300,0,1000,13300,100,890
524,2020-10-26,9.6,0,8500,0,227300,-218800,4500,43150
525,2020-10-23,9.7,0,12600,0,150800,-138200,500,4730
526,2020-10-22,9.7,0,1800,0,52600,-50800,0,0
527,2020-10-21,9.7,0,23700,0,79800,-56100,2800,25100
528,2020-10-20,9.8,0,1300,0,250800,-249500,100,980
529,2020-10-19,9.5,0,54600,0,329600,-275000,52300,502120
530,2020-10-16,9.5,0,4000,0,2000,2000,900,8550
531,2020-10-15,10.1,0,4400,0,330600,-326200,2000,20200
532,2020-10-14,10.2,0,9900,0,3700,6200,200,1960
533,2020-10-13,10.3,0,4800,0,6300,-1500,3000,28340
534,2020-10-12,10.4,0,6400,0,133200,-126800,4100,41140
535,2020-10-09,9.9,0,13600,0,330700,-317100,1700,16770
536,2020-10-08,9.6,0,9600,0,10700,-1100,4900,46760
537,2020-10-07,9.9,0,4500,0,2400,2100,200,1940
538,2020-10-06,9.9,0,2900,0,3400,-500,200,1920
539,2020-10-05,9.9,0,14100,0,105000,-90900,2200,21150
540,2020-10-02,9.6,0,3100,0,331300,-328200,1700,16340
541,2020-10-01,9.9,0,4100,0,304800,-300700,1800,17180
542,2020-09-30,9.9,0,3700,0,4100,-400,1000,9690
543,2020-09-29,9.8,0,1900,0,203100,-201200,200,1920
544,2020-09-28,9.7,0,6400,0,329400,-323000,200,1900
545,2020-09-25,9.9,0,6200,0,203300,-197100,200,1950
546,2020-09-24,9.9,0,5900,0,330400,-324500,900,8810
547,2020-09-23,10.0,0,6800,0,179800,-173000,300,2950
548,2020-09-22,9.9,0,6700,0,131300,-124600,2600,25010
549,2020-09-21,10.0,0,6600,0,132200,-125600,3300,32170
550,2020-09-18,9.5,0,9200,0,103200,-94000,1800,17380
551,2020-09-17,9.5,0,16100,0,53000,-36900,300,3010
552,2020-09-16,9.9,0,6400,0,159000,-152600,3500,35250
553,2020-09-15,10.8,0,5200,0,129100,-123900,700,7120
554,2020-09-14,10.0,0,7300,0,63500,-56200,4300,42940
555,2020-09-11,10.5,0,5100,0,259200,-254100,2800,29380
556,2020-09-10,10.9,0,3800,0,102400,-98600,700,7320
557,2020-09-09,10.5,0,300,0,104200,-103900,300,3150
558,2020-09-08,10.7,0,1400,0,104800,-103400,0,0
559,2020-09-07,10.7,0,5300,0,73300,-68000,200,2140
560,2020-09-04,10.5,0,13100,0,167700,-154600,8700,90150
561,2020-09-03,9.6,0,5900,0,5000,900,3900,37440
562,2020-09-01,9.6,0,4800,0,1700,3100,100,960
563,2020-08-31,9.3,0,1200,0,16900,-15700,0,0
564,2020-08-28,9.3,0,13200,0,11700,1500,5100,47000
565,2020-08-27,9.3,0,11100,0,4800,6300,300,2790
566,2020-08-26,9.3,0,4600,0,4000,600,100,930
567,2020-08-25,9.3,0,6100,0,6500,-400,500,4710
568,2020-08-24,9.4,0,18500,0,17500,1000,14900,141070
569,2020-08-21,9.6,0,2700,0,10000,-7300,1400,14200
570,2020-08-20,10.5,0,9600,0,10200,-600,6600,60850
571,2020-08-19,10.1,0,1500,0,4700,-3200,700,6860
572,2020-08-18,10.2,0,2200,0,5700,-3500,1300,12830
573,2020-08-17,10.1,0,900,0,37000,-36100,600,6970
574,2020-08-14,11.1,0,18900,0,18600,300,18600,206460
575,2020-08-13,10.1,0,10500,0,13300,-2800,9700,97820
576,2020-08-12,9.2,0,10400,0,3500,6900,3500,32200
577,2020-08-11,8.4,0,2200,0,700,1500,700,5930
578,2020-08-10,8.1,0,1100,0,0,1100,0,0
579,2020-08-07,8.1,0,3600,0,0,3600,0,0
580,2020-08-06,8.1,0,3500,0,0,3500,0,0
581,2020-08-05,8.1,0,500,0,0,500,0,0
582,2020-08-04,8.1,0,600,0,200,400,100,810
583,2020-08-03,8.3,0,1300,0,700,600,600,4990
584,2020-07-31,8.1,0,800,0,100,700,0,0
585,2020-07-30,8.1,0,500,0,100,400,0,0
586,2020-07-29,8.1,0,400,0,0,400,0,0
587,2020-07-28,8.1,0,300,0,300,0,100,810
588,2020-07-27,9.0,0,1700,0,700,1000,500,4500
589,2020-07-24,9.0,0,300,0,700,-400,0,0
590,2020-07-23,9.0,0,2000,0,800,1200,100,900
591,2020-07-22,9.8,0,1200,0,1100,100,500,4900
592,2020-07-21,9.1,0,500,0,200,300,100,910
593,2020-07-20,9.0,0,1300,0,600,700,500,4610
594,2020-07-17,8.9,0,8700,0,1000,7700,600,5310
595,2020-07-16,9.3,0,800,0,400,400,300,2860
596,2020-07-15,9.1,0,6200,0,3500,2700,1300,13250
597,2020-07-14,9.8,0,1300,0,700,600,500,4900
598,2020-07-13,9.8,0,17100,0,800,16300,500,4630
599,2020-07-10,9.2,0,11200,0,700,10500,200,1960
600,2020-07-09,9.7,0,2000,0,300,1700,300,2870
601,2020-07-08,8.9,0,6900,0,300,6600,100,890
602,2020-07-07,9.2,0,1900,0,1900,0,1200,11590
603,2020-07-06,9.7,0,2700,0,1900,800,1200,11620
604,2020-07-03,9.5,0,2900,0,200,2700,0,0
605,2020-07-02,9.5,0,1000,0,355900,-354900,300,2830
606,2020-07-01,10.2,0,10700,0,300,10400,300,3060
607,2020-06-30,9.3,0,7900,0,900,7000,900,8720
608,2020-06-29,9.1,0,7400,0,352400,-345000,100,910
609,2020-06-26,10.1,0,6700,0,200,6500,200,2010
610,2020-06-25,9.2,0,7700,0,351900,-344200,0,0
611,2020-06-24,9.2,0,7000,0,352100,-345100,100,920
612,2020-06-23,9.3,0,7000,0,352000,-345000,200,1940
613,2020-06-22,9.2,0,9200,0,500,8700,200,1890
614,2020-06-19,8.9,0,8900,0,100,8800,0,0
615,2020-06-18,8.9,0,10900,0,1100,9800,300,2810
616,2020-06-17,9.6,0,2100,0,2000,100,1600,15360
617,2020-06-16,9.6,0,4100,0,354200,-350100,2100,20330
618,2020-06-15,9.6,0,600,0,1600,-1000,0,0
619,2020-06-12,9.6,0,2400,0,353600,-351200,300,2920
620,2020-06-11,10.1,0,2200,0,354100,-351900,300,3020
621,2020-06-10,9.9,0,1200,0,355100,-353900,1200,12300
622,2020-06-09,11.0,0,1800,0,352500,-350700,200,2020
623,2020-06-08,10.1,0,3100,0,353000,-349900,400,4240
624,2020-06-05,10.7,0,1600,0,354900,-353300,300,3090
625,2020-06-04,9.9,0,7700,0,356100,-348400,4600,45410
626,2020-06-03,9.0,0,3400,0,2400,1000,2200,19750
627,2020-06-02,9.0,0,6600,0,0,6600,0,0
628,2020-06-01,9.0,0,2800,0,200,2600,100,900
629,2020-05-29,9.9,0,800,0,1700,-900,100,990
630,2020-05-28,10.0,0,2800,0,900,1900,100,1000
631,2020-05-27,9.4,0,4200,0,500,3700,300,2860
632,2020-05-26,9.1,0,1000,0,3100,-2100,100,910
633,2020-05-25,9.9,0,1100,0,354000,-352900,200,1980
634,2020-05-22,10.6,0,2800,0,2800,0,2200,21640
635,2020-05-21,9.9,0,1200,0,100,1100,100,990
636,2020-05-20,9.0,0,1300,0,0,1300,0,0
637,2020-05-19,9.0,0,8100,0,200,7900,100,900
638,2020-05-18,10.0,0,11200,0,4100,7100,2700,26880
639,2020-05-15,9.7,0,5200,0,700,4500,500,4970
640,2020-05-14,10.3,0,1900,0,800,1100,300,3090
641,2020-05-13,11.4,0,4900,0,4600,300,4300,41900
642,2020-05-12,10.7,0,200,0,354000,-353800,200,2300
643,2020-05-11,11.8,0,0,0,352200,-352200,0,0
644,2020-05-08,11.8,0,2900,0,358600,-355700,2600,27790
645,2020-05-07,11.7,0,800,0,4900,-4100,500,5530
646,2020-05-06,11.3,0,500,0,300,200,100,1130
647,2020-05-05,10.4,0,600,0,600,0,300,3130
648,2020-05-04,10.6,0,400,0,352000,-351600,0,0
649,2020-04-29,10.6,0,400,0,352100,-351700,300,3180
650,2020-04-28,11.0,0,1400,0,300,1100,100,1100
651,2020-04-27,10.2,0,600,0,352300,-351700,400,4140
652,2020-04-24,11.2,0,2200,0,700,1500,500,5240
653,2020-04-23,10.3,0,3200,0,1100,2100,800,7470
654,2020-04-22,9.6,0,400,0,351900,-351500,0,0
655,2020-04-21,9.6,0,500,0,200,300,0,0
656,2020-04-20,9.6,0,600,0,1000,-400,300,2810
657,2020-04-17,9.5,0,1300,0,800,500,200,1940
658,2020-04-16,10.0,0,300,0,352500,-352200,0,0
659,2020-04-15,10.0,0,1300,0,352300,-351000,0,0
660,2020-04-14,10.0,0,4400,0,1400,3000,600,5950
661,2020-04-13,9.7,0,1500,0,700,800,0,0
662,2020-04-10,9.7,0,3900,0,900,3000,200,1970
663,2020-04-09,9.1,0,2900,0,500,2400,400,3750
664,2020-04-08,9.1,0,2900,0,351800,-348900,100,910
665,2020-04-07,10.0,0,5500,0,1800,3700,1600,15980
666,2020-04-06,9.1,0,5900,0,700,5200,600,5370
667,2020-04-03,8.3,0,800,0,100,700,100,830
668,2020-04-01,7.6,0,1100,0,800,300,800,6530
669,2020-03-31,7.8,0,700,0,1600,-900,700,5870
670,2020-03-30,8.4,0,900,0,1800,-900,700,6430
671,2020-03-27,9.3,0,1000,0,300,700,300,2780
672,2020-03-26,9.1,0,500,0,300,200,100,910
673,2020-03-25,9.6,0,800,0,400,400,300,2840
674,2020-03-24,9.7,0,4800,0,2000,2800,400,3880
675,2020-03-23,9.7,0,400,0,700,-300,300,2910
676,2020-03-20,10.7,0,300,0,352400,-352100,300,3210
677,2020-03-19,11.8,0,100,0,800,-700,100,1180
678,2020-03-18,11.0,0,100,0,500,-400,100,1100
679,2020-03-17,10.2,0,0,0,1600,-1600,0,0
680,2020-03-16,10.2,0,0,0,800,-800,0,0
681,2020-03-13,10.2,0,6300,0,8100,-1800,6300,64260
682,2020-03-12,11.3,0,4700,0,357200,-352500,4700,53110
683,2020-03-11,12.5,0,1200,0,352500,-351300,1100,13200
684,2020-03-10,11.5,0,400,0,352200,-351800,100,1150
685,2020-03-09,12.7,0,400,0,352700,-352300,400,5210
686,2020-03-06,14.1,0,900,0,700,200,700,9640
687,2020-03-05,12.9,0,400,0,600,-200,200,2410
688,2020-03-04,12.4,0,200,0,352800,-352600,100,1240
689,2020-03-03,13.7,0,300,0,353200,-352900,200,2940
690,2020-03-02,15.2,0,0,0,352800,-352800,0,0
691,2020-02-28,15.2,0,0,0,352500,-352500,0,0
692,2020-02-27,15.2,0,0,0,352700,-352700,0,0
693,2020-02-26,15.2,0,0,0,351600,-351600,0,0
694,2020-02-25,15.2,0,0,0,2400,-2400,0,0
695,2020-02-24,15.2,0,500,0,2300,-1800,500,7630
696,2020-02-21,16.8,0,0,0,352500,-352500,0,0
697,2020-02-20,16.8,0,0,0,352700,-352700,0,0
698,2020-02-19,16.8,0,0,0,350400,-350400,0,0
699,2020-02-18,16.8,0,0,0,800,-800,0,0
700,2020-02-17,16.8,0,700,0,353800,-353100,700,11760
701,2020-02-14,18.6,0,0,0,2500,-2500,0,0
702,2020-02-13,18.6,0,900,0,390600,-389700,900,16750
703,2020-02-12,20.6,0,400,0,800,-400,400,7600
704,2020-02-11,19.1,0,11000,0,16700,-5700,11000,180680
705,2020-02-10,18.2,0,300,0,12500,-12200,200,3410
706,2020-02-07,17.5,0,500,0,400,100,300,4960
707,2020-02-06,16.2,0,200,0,1900,-1700,200,3240
708,2020-02-05,17.9,0,600,0,3200,-2600,400,7010
709,2020-02-04,18.3,0,800,0,351400,-350600,300,5010
710,2020-02-03,16.7,0,200,0,700,-500,200,3090
711,2020-01-31,15.7,0,2700,0,2200,500,2100,32410
712,2020-01-30,14.3,0,500,0,500,0,400,5460
713,2020-01-22,13.0,0,600,0,300,300,200,2640
714,2020-01-21,12.5,0,4600,0,700,3900,600,7300
715,2020-01-20,11.7,0,300,0,100,200,0,0
716,2020-01-17,11.7,0,300,0,0,300,0,0
717,2020-01-16,11.7,0,300,0,0,300,0,0
718,2020-01-15,11.7,0,300,0,0,300,0,0
719,2020-01-14,11.7,0,300,0,300,0,200,2360
720,2020-01-13,11.3,0,300,0,100,200,0,0
721,2020-01-10,11.3,0,1300,0,100,1200,100,1130
722,2020-01-09,10.3,0,1600,0,300,1300,300,3090
723,2020-01-08,9.4,0,3000,0,400,2600,400,3760
724,2020-01-07,8.7,0,1100,0,0,1100,0,0
725,2020-01-06,8.7,0,1100,0,0,1100,0,0
726,2020-01-03,8.7,0,1800,0,300,1500,300,2760
727,2020-01-02,9.1,0,800,0,0,800,0,0
728,2019-12-31,9.1,0,1500,0,0,1500,0,0
729,2019-12-30,9.1,0,3300,0,1500,1800,1500,13530
730,2019-12-27,8.4,0,2400,0,100,2300,100,840
731,2019-12-26,9.0,0,1600,0,1000,600,700,6340
732,2019-12-25,9.9,0,5900,0,5300,600,5200,55290
733,2019-12-24,9.8,0,600,0,200,400,200,1960
734,2019-12-23,10.1,0,400,0,100,300,100,1010
735,2019-12-20,10.6,0,1000,0,600,400,100,1060
736,2019-12-19,11.1,0,700,0,200,500,100,1110
737,2019-12-18,10.1,0,400,0,200,200,100,1010
738,2019-12-17,10.6,0,800,0,0,800,0,0
739,2019-12-16,10.6,0,800,0,300,500,300,3380
740,2019-12-13,10.6,0,600,0,100,500,0,0
741,2019-12-12,10.6,0,1700,0,100,1600,0,0
742,2019-12-11,10.6,0,700,0,0,700,0,0
743,2019-12-10,10.6,0,1700,0,300,1400,200,2120
744,2019-12-09,11.1,0,1800,0,300,1500,100,1110
745,2019-12-06,11.9,0,3600,0,1100,2500,800,8940
746,2019-12-05,11.0,0,5800,0,3000,2800,3000,39350
747,2019-12-04,12.0,0,100,0,1000,-900,0,0
748,2019-12-03,12.0,0,1300,0,800,500,0,0
749,2019-12-02,12.0,0,0,0,800,-800,0,0
750,2019-11-29,12.0,0,3300,0,500,2800,0,0
751,2019-11-28,12.0,0,0,0,900,-900,0,0
752,2019-11-27,12.0,0,3300,0,600,2700,0,0
753,2019-11-26,12.0,0,3700,0,600,3100,0,0
754,2019-11-25,12.0,0,1100,0,400,700,0,0
755,2019-11-22,12.0,0,0,0,400,-400,0,0
756,2019-11-21,12.0,0,1100,0,400,700,0,0
757,2019-11-20,12.0,0,1300,0,300,1000,0,0
758,2019-11-19,12.0,0,1100,0,600,500,300,3600
759,2019-11-18,12.0,0,100,0,300,-200,0,0
760,2019-11-15,12.0,0,2300,0,400,1900,100,1200
761,2019-11-14,13.2,0,3900,0,600,3300,500,6600
762,2019-11-13,12.0,0,1500,0,500,1000,0,0
763,2019-11-12,12.0,0,4600,0,4300,300,3400,40410
764,2019-11-11,11.9,0,1300,0,100,1200,100,1190
765,2019-11-08,11.1,0,900,0,200,700,100,1110
766,2019-11-07,11.6,0,1200,0,300,900,300,3320
767,2019-11-06,11.3,0,1100,0,200,900,100,1130
768,2019-11-05,11.9,0,300,0,300,0,100,1190
769,2019-11-04,12.9,0,3000,0,2200,800,2200,27790
770,2019-11-01,11.8,0,1100,0,800,300,500,5730
771,2019-10-31,11.3,0,1600,0,900,700,200,2220
772,2019-10-30,11.3,0,900,0,1700,-800,200,2330
773,2019-10-29,12.3,0,2500,0,1600,900,800,9610
774,2019-10-28,11.8,0,6300,0,4500,1800,4200,49600
775,2019-10-25,10.9,0,1100,0,1900,-800,100,1090
776,2019-10-24,11.1,0,2700,0,300,2400,200,2290
777,2019-10-23,10.8,0,1500,0,800,700,0,0
778,2019-10-22,10.8,0,700,0,800,-100,0,0
779,2019-10-21,10.8,0,600,0,0,600,0,0
780,2019-10-18,10.8,0,800,0,1000,-200,100,1080
781,2019-10-17,11.1,0,500,0,2100,-1600,100,1110
782,2019-10-16,11.6,0,1700,0,3400,-1700,500,5960
783,2019-10-15,12.2,0,1300,0,400,900,400,4820
784,2019-10-14,11.1,0,700,0,600,100,100,1110
785,2019-10-11,11.5,0,1400,0,100,1300,100,1150
786,2019-10-10,10.5,0,2700,0,1100,1600,1100,11820
787,2019-10-09,10.5,0,1200,0,300,900,100,1050
788,2019-10-08,10.7,0,800,0,800,0,100,1070
789,2019-10-07,11.1,0,600,0,1800,-1200,100,1110
790,2019-10-04,11.7,0,600,0,1200,-600,300,3550
791,2019-10-03,12.1,0,1600,0,800,800,300,3710
792,2019-10-02,12.8,0,600,0,600,0,200,2360
793,2019-10-01,12.0,0,2500,0,200,2300,100,1200
794,2019-09-30,11.0,0,4100,0,3000,1100,2600,29730
795,2019-09-27,12.2,0,900,0,1200,-300,700,8620
796,2019-09-26,13.2,0,800,0,100,700,100,1320
797,2019-09-25,12.0,0,500,0,0,500,0,0
798,2019-09-24,12.0,0,400,0,100,300,100,1200
799,2019-09-23,12.8,0,500,0,100,400,0,0
800,2019-09-20,12.8,0,2400,0,400,2000,0,0
801,2019-09-19,12.8,0,800,0,200,600,100,1280
802,2019-09-18,13.3,0,300,0,700,-400,100,1330
803,2019-09-17,14.6,0,1200,0,800,400,300,4200
804,2019-09-16,13.3,0,600,0,200,400,100,1330
805,2019-09-13,14.0,0,700,0,600,100,300,4130
806,2019-09-12,13.9,0,1500,0,1000,500,600,7900
807,2019-09-11,12.8,0,900,0,0,900,0,0
808,2019-09-10,12.8,0,700,0,100,600,0,0
809,2019-09-09,12.8,0,700,0,0,700,0,0
810,2019-09-06,12.8,0,500,0,100,400,100,1280
811,2019-09-05,13.6,0,600,0,2400,-1800,100,1360
812,2019-09-04,14.5,0,300,0,2700,-2400,100,1450
813,2019-09-03,15.4,0,5700,0,11400,-5700,5200,81150
814,2019-08-30,16.6,0,1100,0,2000,-900,200,3350
815,2019-08-29,16.7,0,900,0,900,0,0,0
816,2019-08-28,16.7,0,400,0,300,100,0,0
817,2019-08-27,16.7,0,1100,0,500,600,200,3340
818,2019-08-26,16.3,0,1600,0,1000,600,0,0
819,2019-08-23,16.3,0,2200,0,800,1400,300,4950
820,2019-08-22,16.8,0,2200,0,700,1500,400,6580
821,2019-08-21,16.2,0,7100,0,900,6200,900,14350
822,2019-08-20,14.8,0,6200,0,1000,5200,100,1480
823,2019-08-19,16.2,0,6800,0,207300,-200500,5200,86140
824,2019-08-16,17.9,0,3200,0,1800,1400,1000,17880
825,2019-08-15,19.1,0,1100,0,900,200,100,1910
826,2019-08-14,20.5,0,1900,0,300,1600,0,0
827,2019-08-13,20.5,0,2400,0,2600,-200,1400,30730
828,2019-08-12,22.4,0,2500,0,1900,600,1200,27500
829,2019-08-09,22.6,0,800,0,345800,-345000,300,6860
830,2019-08-08,22.6,0,2000,0,2700,-700,200,4530
831,2019-08-07,22.7,0,2900,0,349900,-347000,300,6630
832,2019-08-06,22.8,0,1500,0,345900,-344400,200,4690
833,2019-08-05,22.8,0,1500,0,1100,400,200,4580
834,2019-08-02,22.8,0,1400,0,348000,-346600,200,4580
835,2019-08-01,23.0,0,1500,0,348200,-346700,100,2300
836,2019-07-31,23.8,0,2300,0,348700,-346400,1200,28450
837,2019-07-30,22.6,0,2100,0,700,1400,200,4300
838,2019-07-29,22.6,0,600,0,1100,-500,100,2260
839,2019-07-26,23.5,0,2200,0,500,1700,100,2350
840,2019-07-25,21.7,0,1400,0,300,1100,0,0
841,2019-07-24,21.7,0,1400,0,350500,-349100,200,4360
842,2019-07-23,21.9,0,1300,0,350800,-349500,0,0
843,2019-07-22,21.9,0,1000,0,3400,-2400,0,0
844,2019-07-19,21.9,0,2500,0,346800,-344300,700,15630
845,2019-07-18,23.0,0,1800,0,4200,-2400,400,8980
846,2019-07-17,23.0,0,600,0,600,0,0,0
847,2019-07-16,23.0,0,600,0,346300,-345700,0,0
848,2019-07-15,23.0,0,1800,0,346400,-344600,700,16280
849,2019-07-12,23.0,0,600,0,346300,-345700,0,0
850,2019-07-11,23.0,0,700,0,1700,-1000,0,0
851,2019-07-10,23.0,0,900,0,345700,-344800,0,0
852,2019-07-09,23.0,0,1300,0,1500,-200,0,0
853,2019-07-08,23.0,0,1200,0,1200,0,300,6890
854,2019-07-05,24.8,0,1100,0,346200,-345100,100,2480
855,2019-07-04,22.8,0,1000,0,500,500,0,0
856,2019-07-03,22.8,0,900,0,1500,-600,100,2280
857,2019-07-02,22.9,0,600,0,4500,-3900,0,0
858,2019-07-01,22.9,0,900,0,348800,-347900,100,2290
859,2019-06-28,24.0,0,800,0,800,0,300,7200
860,2019-06-27,22.6,0,1400,0,1400,0,500,11220
861,2019-06-26,22.8,0,400,0,500,-100,200,4660
862,2019-06-25,22.9,0,500,0,900,-400,200,4580
863,2019-06-24,22.9,0,700,0,348300,-347600,0,0
864,2019-06-21,22.9,0,800,0,346300,-345500,400,9170
865,2019-06-20,23.2,0,800,0,346000,-345200,300,6950
866,2019-06-19,23.9,0,1000,0,1900,-900,100,2390
867,2019-06-18,23.9,0,1000,0,1600,-600,300,7060
868,2019-06-17,22.9,0,900,0,1700,-800,300,6980
869,2019-06-14,24.6,0,1000,0,600,400,200,4730
870,2019-06-13,22.8,0,1000,0,346800,-345800,600,13680
871,2019-06-12,22.9,0,1200,0,2000,-800,500,11570
872,2019-06-11,24.0,0,1400,0,301100,-299700,400,9500
873,2019-06-10,23.1,0,900,0,301900,-301000,200,4610
874,2019-06-07,24.4,0,900,0,300700,-299800,200,4720
875,2019-06-06,22.5,0,800,0,700,100,200,4420
876,2019-06-05,22.1,0,4500,0,700,3800,200,4210
877,2019-06-04,22.2,0,900,0,1800,-900,400,8880
878,2019-06-03,22.6,0,1300,0,800,500,400,9040
879,2019-05-31,24.0,0,2900,0,2700,200,1700,39290
880,2019-05-30,22.9,0,16500,0,16200,300,15000,341710
881,2019-05-29,21.5,0,1600,0,2600,-1000,700,15050
882,2019-05-28,22.1,0,2500,0,1600,900,500,10680
883,2019-05-27,21.4,0,1400,0,3100,-1700,1100,23690
884,2019-05-24,23.6,0,3400,0,2300,1100,1700,38380
885,2019-05-23,21.7,0,7400,0,5600,1800,5500,111720
886,2019-05-22,20.4,0,3000,0,10000,-7000,1400,29630
887,2019-05-21,21.9,0,3200,0,6200,-3000,2400,53420
888,2019-05-20,22.4,0,2700,0,13200,-10500,2700,61340
889,2019-05-17,24.8,0,1000,0,345800,-344800,400,9670
890,2019-05-16,23.7,0,2000,0,2100,-100,600,14140
891,2019-05-15,23.8,0,900,0,353900,-353000,600,14610
892,2019-05-14,25.4,0,1100,0,348800,-347700,400,9850
893,2019-05-13,24.9,0,1300,0,346100,-344800,500,12180
894,2019-05-10,25.0,0,1100,0,9100,-8000,400,9610
895,2019-05-09,23.9,0,700,0,346200,-345500,200,4780
896,2019-05-08,24.7,0,1000,0,800,200,100,2470
897,2019-05-07,22.9,0,2600,0,2800,-200,1800,42040
898,2019-05-06,23.9,0,1800,0,1600,200,900,21360
899,2019-05-03,24.5,0,1600,0,2100,-500,900,21490
900,2019-05-02,23.8,0,1200,0,2300,-1100,500,11820
901,2019-04-26,23.6,0,2500,0,8900,-6400,2200,53030
902,2019-04-25,24.4,0,1000,0,1500,-500,200,4800
903,2019-04-24,24.7,0,1000,0,1200,-200,200,4780
904,2019-04-23,23.1,0,1100,0,1200,-100,500,11600
905,2019-04-22,23.5,0,1300,0,2400,-1100,800,18690
906,2019-04-19,23.8,0,1200,0,4200,-3000,400,9470
907,2019-04-18,23.4,0,1100,0,2000,-900,300,6990
908,2019-04-17,23.4,0,1400,0,2400,-1000,200,4650
909,2019-04-16,23.6,0,1000,0,1000,0,300,7000
910,2019-04-12,22.9,0,1000,0,1300,-300,200,4570
911,2019-04-11,22.9,0,900,0,2300,-1400,200,4570
912,2019-04-10,22.9,0,1100,0,2700,-1600,400,9140
913,2019-04-09,22.9,0,1100,0,5500,-4400,300,6860
914,2019-04-08,23.3,0,1000,0,2100,-1100,200,4600
915,2019-04-05,22.8,0,2400,0,12000,-9600,1900,43740
916,2019-04-04,23.0,0,900,0,2300,-1400,200,4570
917,2019-04-03,23.2,0,1400,0,1600,-200,300,6910
918,2019-04-02,22.8,0,1000,0,3300,-2300,200,4540
919,2019-04-01,22.9,0,1300,0,3600,-2300,400,9050
920,2019-03-29,23.3,0,800,0,4900,-4100,500,11650
921,2019-03-28,22.9,0,900,0,3100,-2200,300,6840
922,2019-03-27,22.9,0,900,0,6700,-5800,300,6870
923,2019-03-26,22.8,0,16100,0,18100,-2000,15400,343530
924,2019-03-25,22.7,0,11800,0,3200,8600,200,4530
925,2019-03-22,22.9,0,2700,0,2200,500,500,11370
926,2019-03-21,22.6,0,3400,0,7900,-4500,2700,61090
927,2019-03-20,22.7,0,1700,0,6700,-5000,800,18160
928,2019-03-19,23.4,0,3400,0,4700,-1300,1100,25280
929,2019-03-18,23.5,0,2500,0,3600,-1100,300,6930
930,2019-03-15,23.5,0,1200,0,2900,-1700,300,7000
931,2019-03-14,23.4,0,2300,0,3700,-1400,1300,28660
932,2019-03-13,23.2,0,2400,0,9300,-6900,600,14220
933,2019-03-12,22.8,0,800,0,7900,-7100,200,4560
934,2019-03-11,23.0,0,4400,0,12200,-7800,3500,78890
935,2019-03-08,22.5,0,13000,0,17100,-4100,11400,250490
936,2019-03-07,22.7,0,1500,0,3200,-1700,300,6700
937,2019-03-06,22.3,0,2200,0,5900,-3700,1300,28160
938,2019-03-05,22.5,0,2700,0,8500,-5800,1900,42220
939,2019-03-04,22.1,0,15600,0,17100,-1500,14000,313990
940,2019-03-01,21.3,0,800,0,13700,-12900,100,2130
941,2019-02-28,21.5,0,4600,0,17000,-12400,3700,80890
942,2019-02-27,21.5,0,8000,0,17000,-9000,7100,163120
943,2019-02-26,21.4,0,1000,0,15300,-14300,200,4250
944,2019-02-25,21.5,0,1700,0,12300,-10600,400,8450
945,2019-02-22,21.5,0,1800,0,15000,-13200,700,14980
946,2019-02-21,20.8,0,1500,0,1400,100,600,12570
947,2019-02-20,21.0,0,1400,0,14400,-13000,400,8400
948,2019-02-19,21.5,0,2100,0,8600,-6500,700,14970
949,2019-02-18,20.7,0,1600,0,2300,-700,200,4170
950,2019-02-15,21.3,0,1500,0,12800,-11300,400,8760
951,2019-02-14,21.1,0,900,0,10400,-9500,200,4210
952,2019-02-13,21.4,0,1000,0,12500,-11500,400,8520
953,2019-02-12,21.3,0,900,0,17300,-16400,400,8390
954,2019-02-11,20.8,0,600,0,7200,-6600,300,6270
955,2019-02-01,21.1,0,600,0,13000,-12400,0,0
956,2019-01-31,21.1,0,7400,0,33000,-25600,6900,149920
957,2019-01-30,21.9,0,1700,0,10100,-8400,1300,27720
958,2019-01-29,20.5,0,1900,0,8800,-6900,200,4160
959,2019-01-28,21.3,0,1500,0,9700,-8200,500,10420
960,2019-01-25,21.4,0,500,0,14900,-14400,100,2140
961,2019-01-24,21.2,0,700,0,11700,-11000,200,4240
962,2019-01-23,21.6,0,3900,0,12700,-8800,1000,20550
963,2019-01-22,21.6,0,800,0,13400,-12600,300,6430
964,2019-01-21,21.6,0,1200,0,13300,-12100,400,8860
965,2019-01-18,21.7,0,1600,0,9900,-8300,500,10820
966,2019-01-17,21.6,0,1100,0,12600,-11500,300,6430
967,2019-01-16,21.6,0,1100,0,22300,-21200,500,10740
968,2019-01-15,21.1,0,1100,0,10000,-8900,400,8460
969,2019-01-14,21.2,0,600,0,11400,-10800,200,4210
970,2019-01-11,21.1,0,1100,0,4000,-2900,600,12860
971,2019-01-10,21.4,0,3600,0,7500,-3900,500,10240
972,2019-01-09,20.2,0,800,0,14000,-13200,400,8270
973,2019-01-08,21.3,0,1100,0,12500,-11400,500,10510
974,2019-01-07,20.9,0,3300,0,15500,-12200,1100,23020
975,2019-01-04,21.8,0,1100,0,15000,-13900,800,17280
976,2019-01-03,21.4,0,1900,0,18000,-16100,600,12740
977,2019-01-02,22.0,0,1900,0,11600,-9700,700,14700
978,2018-12-28,22.5,0,21300,0,85800,-64500,17200,390790
979,2018-12-27,22.8,0,4900,0,57700,-52800,3000,69120
980,2018-12-26,22.8,0,5700,0,8200,-2500,4200,93090
981,2018-12-25,21.7,0,1300,0,18000,-16700,800,17380
982,2018-12-24,21.7,0,700,0,26900,-26200,400,8710
983,2018-12-21,22.4,0,7800,0,39200,-31400,5900,130670
984,2018-12-20,21.8,0,900,0,33500,-32600,200,4340
985,2018-12-19,21.9,0,1200,0,28200,-27000,300,6540
986,2018-12-18,22.1,0,9300,0,31000,-21700,8600,198890
987,2018-12-17,21.6,0,2600,0,32400,-29800,1700,37110
988,2018-12-14,22.8,0,21100,0,46600,-25500,9800,220240
989,2018-12-13,21.9,0,1500,0,9000,-7500,800,17550
990,2018-12-12,22.0,0,900,0,10200,-9300,400,8730
991,2018-12-11,21.7,0,2100,0,6300,-4200,800,17800
992,2018-12-10,22.1,0,5000,0,8100,-3100,2500,52690
993,2018-12-07,21.0,0,29600,0,13200,16400,10000,207930
994,2018-12-06,19.5,0,4400,0,7100,-2700,700,13550
995,2018-12-05,18.8,0,23100,0,9400,13700,2100,39190
996,2018-12-04,18.8,0,2400,0,10700,-8300,1400,26330
997,2018-12-03,18.7,0,1500,0,8500,-7000,1000,18980
998,2018-11-30,20.0,0,18700,0,15400,3300,10600,210350
999,2018-11-29,18.6,0,1500,0,14700,-13200,800,14920
1000,2018-11-28,18.4,0,2300,0,15900,-13600,1100,20450
1001,2018-11-27,18.9,0,7100,0,16000,-8900,6400,120500
1002,2018-11-26,18.5,0,2500,0,15000,-12500,500,9200
1003,2018-11-23,18.5,0,8900,0,26200,-17300,8000,150160
1004,2018-11-22,19.0,0,6900,0,25600,-18700,4400,82770
1005,2018-11-21,18.4,0,12900,0,12900,0,1500,27200
1006,2018-11-20,18.5,0,7900,0,21100,-13200,2000,36950
1007,2018-11-19,18.4,0,10500,0,21000,-10500,7700,138680
1008,2018-11-16,18.3,0,3000,0,25800,-22800,1600,29350
1009,2018-11-15,18.4,0,7600,0,35200,-27600,5900,108820
1010,2018-11-14,17.8,0,1100,0,16500,-15400,300,5290
1011,2018-11-13,17.6,0,7700,0,19100,-11400,3200,55820
1012,2018-11-12,17.5,0,1100,0,6300,-5200,400,6970
1013,2018-11-09,17.8,0,8400,0,23100,-14700,6100,107180
1014,2018-11-08,16.9,0,900,0,7800,-6900,200,3370
1015,2018-11-07,17.5,0,1300,0,24300,-23000,600,10370
1016,2018-11-06,17.4,0,1400,0,8800,-7400,400,6860
1017,2018-11-05,17.4,0,2800,0,17700,-14900,700,12010
1018,2018-11-02,17.7,0,1200,0,13200,-12000,400,7080
1019,2018-11-01,16.6,0,10600,0,10700,-100,3600,59720
1020,2018-10-31,17.0,0,55800,0,63300,-7500,43300,708160
1021,2018-10-30,17.3,0,7700,0,18600,-10900,1900,32970
1022,2018-10-29,16.8,0,6700,0,8300,-1600,1300,22470
1023,2018-10-26,17.5,0,6700,0,8400,-1700,1500,26140
1024,2018-10-25,16.8,0,4700,0,16800,-12100,4000,67200
1025,2018-10-24,17.4,0,800,0,4300,-3500,300,5160
1026,2018-10-23,16.6,0,1300,0,11800,-10500,900,15390
1027,2018-10-22,17.0,0,2900,0,8200,-5300,1400,23550
1028,2018-10-19,17.2,0,2000,0,4900,-2900,900,15470
1029,2018-10-18,17.1,0,1500,0,3400,-1900,900,15280
1030,2018-10-17,17.2,0,4200,0,6700,-2500,2700,46220
1031,2018-10-16,17.1,0,3400,0,4600,-1200,1000,17240
1032,2018-10-15,17.2,0,3600,0,10900,-7300,1700,29280
1033,2018-10-12,17.6,0,20300,0,23500,-3200,15800,277370
1034,2018-10-11,16.6,0,14800,0,19000,-4200,12500,207450
1035,2018-10-10,17.2,0,3700,0,9700,-6000,600,10220
1036,2018-10-09,17.2,0,8100,0,6700,1400,1000,17130
1037,2018-10-08,17.3,0,2900,0,6300,-3400,2000,34260
1038,2018-10-05,17.4,0,24400,0,28500,-4100,16600,2965160
1039,2018-10-04,16.4,0,5100,0,12800,-7700,2200,35930
1040,2018-10-03,16.3,0,13400,0,13100,300,6300,101470
1041,2018-10-02,16.3,0,29100,0,19800,9300,6700,110170
1042,2018-10-01,17.2,0,274800,0,289500,-14700,274800,4745740
1043,2018-09-28,19.1,0,8500,0,3400,5100,100,1910
1044,2018-09-27,19.6,0,2100,0,2200,-100,0,0
1045,2018-09-26,19.6,0,20100,0,16900,3200,15600,281280
1046,2018-09-25,18.7,0,4300,0,3300,1000,100,1870
1047,2018-09-24,20.4,0,2100,0,600,1500,300,6120
1048,2018-09-21,20.1,0,4900,0,600,4300,300,6120
1049,2018-09-20,20.1,0,3300,0,400,2900,100,2010
1050,2018-09-19,20.8,0,700,0,900,-200,200,4330
1051,2018-09-18,20.6,0,600,0,300,300,0,0
1052,2018-09-17,20.6,0,3700,0,1200,2500,900,18940
1053,2018-09-14,20.6,0,3300,0,800,2500,100,2060
1054,2018-09-13,21.4,0,2500,0,700,1800,100,2140
1055,2018-09-12,21.3,0,5100,0,6100,-1000,4500,93840
1056,2018-09-11,22.7,0,4100,0,1600,2500,400,9060
1057,2018-09-10,23.0,0,2800,0,4200,-1400,1700,39750
1058,2018-09-07,24.0,0,3000,0,1900,1100,100,2400
1059,2018-09-06,24.7,0,3100,0,2800,300,300,7230
1060,2018-09-05,24.7,0,5700,0,1800,3900,400,9640
1061,2018-09-04,24.4,0,3300,0,2300,1000,200,4730
1062,2018-08-31,25.3,0,2200,0,3100,-900,600,14780
1063,2018-08-30,25.3,0,600,0,3500,-2900,200,4800
1064,2018-08-29,24.9,0,2800,0,5600,-2800,2800,69740
1065,2018-08-28,27.6,0,400,0,10400,-10000,300,7410
1066,2018-08-27,25.7,0,1700,0,13400,-11700,1700,43690
1067,2018-08-24,28.5,0,3800,0,7400,-3600,3600,95250
1068,2018-08-23,28.9,0,2300,0,2500,-200,500,13580
1069,2018-08-22,28.6,0,3000,0,4600,-1600,200,5400
1070,2018-08-21,27.8,0,2200,0,3200,-1000,800,21390
1071,2018-08-20,28.2,0,1600,0,5100,-3500,1200,31390
1072,2018-08-17,28.5,0,1800,0,4900,-3100,500,13830
1073,2018-08-16,26.8,0,2200,0,900,1300,300,7590
1074,2018-08-15,24.6,0,3400,0,7700,-4300,300,7380
1075,2018-08-14,27.1,0,2300,0,5900,-3600,700,18990
1076,2018-08-13,28.8,0,1800,0,6100,-4300,200,5590
1077,2018-08-10,29.0,0,400,0,5800,-5400,300,8500
1078,2018-08-09,30.0,0,1900,0,2700,-800,400,11050
1079,2018-08-08,27.8,0,800,0,5900,-5100,100,2780
1080,2018-08-07,26.0,0,1100,0,5500,-4400,200,5130
1081,2018-08-06,26.5,0,600,0,2400,-1800,200,5300
1082,2018-08-03,26.9,0,2100,0,5800,-3700,500,13450
1083,2018-08-02,26.5,0,3300,0,6200,-2900,300,467710
1084,2018-08-01,25.2,0,2200,0,4200,-2000,100,2520
1085,2018-07-31,27.9,0,3200,0,3700,-500,1100,30500
1086,2018-07-30,26.7,0,3000,0,6200,-3200,500,12950
1087,2018-07-27,24.7,0,3400,0,600,2800,600,14320
1088,2018-07-26,22.5,0,500,0,3500,-3000,200,4480
1089,2018-07-25,24.7,0,2000,0,4300,-2300,500,12010
1090,2018-07-24,26.0,0,1200,0,2200,-1000,800,21210
1091,2018-07-23,27.7,0,2200,0,7500,-5300,100,2770
1092,2018-07-20,26.1,0,1200,0,6300,-5100,700,18510
1093,2018-07-19,27.0,0,2000,0,9400,-7400,1100,29620
1094,2018-07-18,27.4,0,1800,0,9000,-7200,700,18480
1095,2018-07-17,26.0,0,1300,0,7000,-5700,300,7700
1096,2018-07-16,24.7,0,2600,0,3000,-400,1300,31540
1097,2018-07-13,22.6,0,1200,0,3200,-2000,300,7000
1098,2018-07-12,21.8,0,6700,0,3500,3200,3300,1182710
1099,2018-07-11,20.2,0,1900,0,2100,-200,900,18160
1100,2018-07-10,20.2,0,2600,0,4100,-1500,1400,28490
1101,2018-07-09,20.5,0,55200,0,52900,2300,51200,1024080
1102,2018-07-06,19.1,0,3700,0,4300,-600,400,7520
1103,2018-07-05,18.0,0,5900,0,6100,-200,1600,28400
1104,2018-07-04,18.0,0,12100,0,9100,3000,5400,95990
1105,2018-07-03,16.7,0,6500,0,11300,-4800,3200,52890
1106,2018-07-02,15.8,0,3900,0,3500,400,600,9540
1107,2018-06-29,15.2,0,4000,0,12100,-8100,3000,45630
1108,2018-06-28,15.9,0,5200,0,10400,-5200,3200,52480
1109,2018-06-27,16.4,0,7500,0,6500,1000,1900,31200
1110,2018-06-26,15.8,0,2300,0,6200,-3900,1900,29830
1111,2018-06-25,17.2,0,5300,0,2900,2400,1800,28260
1112,2018-06-22,15.8,0,9400,0,5600,3800,4200,3805110
1113,2018-06-21,16.1,0,16400,0,7900,8500,4400,73030
1114,2018-06-20,17.6,0,1200,0,3500,-2300,500,5630210
1115,2018-06-19,18.0,0,8000,0,11900,-3900,6300,114040
1116,2018-06-18,18.7,0,7900,0,6600,1300,3800,78480
1117,2018-06-15,19.1,0,5700,0,13900,-8200,1800,6426290
1118,2018-06-14,20.8,0,5300,0,1100,4200,200,3900
1119,2018-06-13,19.1,0,6800,0,11200,-4400,1100,21580
1120,2018-06-12,20.0,0,15800,0,18600,-2800,11000,6429370
1121,2018-06-11,19.5,0,14100,0,10800,3300,10500,216670
1122,2018-06-08,19.4,0,5800,0,5800,0,3900,80480
1123,2018-06-07,19.8,0,6400,0,6000,400,2200,45190
1124,2018-06-06,19.6,0,1200,0,600,600,100,1960
1125,2018-06-05,19.8,0,2800,0,1800,1000,900,18280
1126,2018-06-04,19.1,0,1900,0,1300,600,100,1910
1127,2018-06-01,19.3,0,6500,0,2600,3900,1000,20330
1128,2018-05-31,21.1,0,9000,0,900,8100,700,14440
1129,2018-05-30,19.6,0,14300,0,1400,12900,100,1960
1130,2018-05-29,20.1,0,10800,0,2900,7900,500,9930
1131,2018-05-28,20.3,0,2800,0,3300,-500,600,12140
1132,2018-05-25,21.3,0,14900,0,4600,10300,3300,70190
1133,2018-05-24,22.5,0,6800,0,8400,-1600,500,11170
1134,2018-05-23,22.6,0,34700,0,32400,2300,30800,696260
1135,2018-05-22,23.9,0,7700,0,12100,-4400,200,4720
1136,2018-05-21,24.6,0,36700,0,28200,8500,15900,411330
1137,2018-05-18,24.9,0,12600,0,11100,1500,1800,44920
1138,2018-05-17,24.9,0,6000,0,6900,-900,200,4980
1139,2018-05-16,24.9,0,15900,0,12400,3500,1200,8215360
1140,2018-05-15,24.9,0,44800,0,75800,-31000,31800,823570
1141,2018-05-14,26.5,0,6700,0,20000,-13300,3000,79320
1142,2018-05-11,26.5,0,16100,0,12300,3800,1800,2972340
1143,2018-05-10,25.0,0,56800,0,52400,4400,46000,10244440
1144,2018-05-09,25.0,0,25400,0,38600,-13200,12100,307090
1145,2018-05-08,24.8,0,25800,0,36200,-10400,21600,568160
1146,2018-05-07,26.9,0,9800,0,16000,-6200,3600,10310930
1147,2018-05-04,26.9,0,13900,0,8100,5800,5600,149430
1148,2018-05-03,25.0,0,4000,0,4400,-400,500,12730
1149,2018-05-02,25.0,0,7900,0,14000,-6100,7900,202660
1150,2018-04-27,27.2,0,18200,0,58500,-40300,17700,473140
1151,2018-04-26,28.0,0,33400,0,39700,-6300,29900,820390
1152,2018-04-24,26.1,0,110400,0,112500,-2100,109000,2762540
1153,2018-04-23,25.9,0,5700,0,7000,-1300,5100,135680
1154,2018-04-20,27.7,0,8000,0,11300,-3300,7200,190880
1155,2018-04-19,28.0,0,2000,0,5800,-3800,1400,38010
1156,2018-04-18,27.7,0,4900,0,8200,-3300,3000,80520
1157,2018-04-17,28.7,0,6600,0,12700,-6100,5900,159780
1158,2018-04-16,28.9,0,2100,0,6400,-4300,200,5780
1159,2018-04-13,28.9,0,3900,0,18400,-14500,3400,98770
1160,2018-04-12,28.2,0,1900,0,12200,-10300,500,14100
1161,2018-04-11,26.8,0,2800,0,12000,-9200,900,24620
1162,2018-04-10,27.9,0,1800,0,16600,-14800,700,19410
1163,2018-04-09,27.9,0,7900,0,19400,-11500,6000,163130
1164,2018-04-06,26.9,36,6919,35,8100,-1181,4600,123440
1165,2018-04-05,26.1,10,1119,11,3800,-2681,200,5210
1166,2018-04-04,26.0,10,2019,18,4800,-2781,400,10420
1167,2018-04-03,26.1,17,2699,16,9000,-6301,700,18260
1168,2018-04-02,26.5,13,1820,17,4700,-2880,800,21070
1169,2018-03-30,28.0,22,10719,24,23300,-12581,6000,167720
1170,2018-03-29,27.4,22,4100,28,23500,-19400,2700,73590
1171,2018-03-28,27.3,12,1800,22,21700,-19900,1300,35300
1172,2018-03-27,27.5,13,1300,16,10000,-8700,600,16350
1173,2018-03-26,27.6,14,3000,23,11000,-8000,2900,76950
1174,2018-03-23,28.9,1,100,15,11400,-11300,100,2890
1175,2018-03-22,28.9,7,4300,23,13000,-8700,2000,56140
1176,2018-03-21,27.5,26,6900,18,13100,-6200,5600,147160
1177,2018-03-20,25.5,10,4100,4,1200,2900,1200,28950
1178,2018-03-19,23.2,7,14000,5,1400,12600,1400,30440
1179,2018-03-16,21.1,27,29600,31,84000,-54400,29600,629130
1180,2018-03-15,23.4,18,30300,19,43400,-13100,30300,711450
1181,2018-03-14,26.0,34,36700,37,46500,-9800,36700,962970
1182,2018-03-13,28.8,18,3200,26,7500,-4300,1700,49280
1183,2018-03-12,29.2,7,1800,18,4100,-2300,300,8760
1184,2018-03-09,29.6,24,5100,24,173300,-168200,3000,88760
1185,2018-03-08,30.5,19,9300,21,71400,-62100,7500,227190
1186,2018-03-07,29.8,9,1200,19,209700,-208500,300,8880
1187,2018-03-06,29.7,11,1500,17,3500,-2000,600,17620
1188,2018-03-05,29.9,9,1100,20,167000,-165900,300,8900
1189,2018-03-02,30.0,8,900,21,13600,-12700,300,8910
1190,2018-03-01,30.9,10,1400,21,165400,-164000,300,9040
1191,2018-02-28,31.9,17,19500,33,192400,-172900,18300,580900
1192,2018-02-27,31.6,12,3000,15,165200,-162200,1800,55430
1193,2018-02-26,29.3,12,1800,12,163900,-162100,900,26450
1194,2018-02-23,30.0,20,3900,29,11600,-7700,2600,78850
1195,2018-02-22,29.2,19,1900,32,7300,-5400,1500,44880
1196,2018-02-21,30.5,11,2600,24,13300,-10700,2200,72850
1197,2018-02-13,31.2,12,3300,17,3900,-600,2200,68060
1198,2018-02-12,28.6,6,900,10,1400,-500,200,5720
1199,2018-02-09,28.8,10,2300,11,6100,-3800,800,22950
1200,2018-02-08,28.0,9,7300,10,14800,-7500,7200,201410
1201,2018-02-07,30.7,8,900,14,3100,-2200,200,6230
1202,2018-02-06,28.8,5,500,8,2400,-1900,200,5760
1203,2018-02-05,29.9,6,1000,15,16600,-15600,100,2990
1204,2018-02-02,29.9,5,500,15,5100,-4600,100,2990
1205,2018-02-01,29.9,11,1200,17,16100,-14900,400,12060
1206,2018-01-31,31.9,13,8500,18,8900,-400,5500,174980
1207,2018-01-30,29.4,12,2000,13,6100,-4100,500,14330
1208,2018-01-29,29.6,14,2900,12,4600,-1700,1200,35660
1209,2018-01-26,29.7,18,10900,12,8500,2400,7800,220660
1210,2018-01-25,27.9,23,30800,20,29000,1800,26700,747440
1211,2018-01-24,27.7,32,11400,33,15100,-3700,8900,257900
1212,2018-01-23,28.4,13,6700,11,6100,600,4000,110690
1213,2018-01-22,29.1,4,800,4,1100,-300,100,2910
1214,2018-01-19,28.9,4,500,9,3400,-2900,300,8670
1215,2018-01-18,28.9,3,300,6,2600,-2300,100,2890
1216,2018-01-17,28.9,3,300,9,3000,-2700,250,7250
1217,2018-01-16,28.9,7,800,9,4100,-3300,200,5780
1218,2018-01-15,28.5,6,1000,7,4000,-3000,800,22850
1219,2018-01-12,29.0,7,800,7,5000,-4200,200,5800
1220,2018-01-11,28.9,7,2200,14,10000,-7800,1800,52280
1221,2018-01-10,29.3,5,2800,7,264500,-261700,0,0
1222,2018-01-09,29.3,10,11300,12,268500,-257200,3200,93740
1223,2018-01-08,29.8,15,9400,14,18400,-9000,5900,176890
1224,2018-01-05,30.0,9,2800,18,13600,-10800,1300,38970
1225,2018-01-04,30.0,12,7900,12,12200,-4300,1100,33000
1226,2018-01-03,29.3,10,4100,16,262300,-258200,300,8710
1227,2018-01-02,30.0,14,17600,15,278200,-260600,10200,305650
1228,2017-12-29,30.9,10,1700,32,14900,-13200,1100,278120
1229,2017-12-28,31.3,14,2300,18,10400,-8100,510,15308
1230,2017-12-27,30.8,8,4000,21,11400,-7400,1100,33590
1231,2017-12-26,30.7,8,2300,14,20000,-17700,300,9000
1232,2017-12-25,31.4,5,3500,11,22000,-18500,240,7536
1233,2017-12-22,31.6,16,19900,16,25100,-5200,12300,361380
1234,2017-12-21,30.1,11,5000,15,7300,-2300,900,26640
1235,2017-12-20,30.0,14,7600,18,8200,-600,3000,90000
1236,2017-12-19,31.7,7,2200,10,4700,-2500,300,9510
1237,2017-12-18,29.7,10,6000,13,6200,-200,300,9040
1238,2017-12-15,29.6,13,7100,15,10400,-3300,300,8840
1239,2017-12-14,29.3,8,1200,8,4700,-3500,300,8790
1240,2017-12-13,29.2,11,9600,12,7400,2200,2300,67340
1241,2017-12-12,29.7,18,12500,17,17600,-5100,10700,310610
1242,2017-12-11,29.7,16,3600,14,18400,-14800,1400,41750
1243,2017-12-08,30.5,12,1900,15,12600,-10700,300,9150
1244,2017-12-07,29.7,16,11300,21,10000,1300,5700,171550
1245,2017-12-06,29.8,12,4600,19,9100,-4500,1300,38740
1246,2017-12-05,29.9,7,900,11,6900,-6000,200,5950
1247,2017-12-04,29.9,6,800,11,4300,-3500,100,2990
1248,2017-12-01,29.7,9,900,14,4400,-3500,300,8940
1249,2017-11-30,28.6,13,5000,20,6100,-1100,700,20790
1250,2017-11-29,29.9,8,5800,9,5800,0,200,6010
1251,2017-11-28,30.0,15,7500,29,13700,-6200,1710,52364
1252,2017-11-27,31.5,11,6600,10,3600,3000,200,6300
1253,2017-11-24,29.8,8,1900,24,9100,-7200,300,8860
1254,2017-11-23,30.0,9,1200,12,6500,-5300,300,8820
1255,2017-11-22,30.0,7,6300,13,6700,-400,400,12000
1256,2017-11-21,29.1,25,13300,21,19600,-6300,9800,282940
1257,2017-11-20,31.8,10,3300,14,13800,-10500,620,19114
1258,2017-11-17,31.8,5,3600,11,3100,500,500,15530
1259,2017-11-16,30.0,16,6000,15,5800,200,2000,59870
1260,2017-11-15,30.0,12,4400,24,8800,-4400,2200,65730
1261,2017-11-14,29.9,16,7200,17,8500,-1300,1800,53920
1262,2017-11-13,30.1,15,5800,13,8700,-2900,900,26800
1263,2017-11-10,30.3,7,3100,18,7600,-4500,600,18060
1264,2017-11-09,30.4,11,16400,18,16800,-400,2400,559360
1265,2017-11-08,29.9,18,17100,11,16100,1000,800,23490
1266,2017-11-07,30.0,10,1700,8,5200,-3500,400,11730
1267,2017-11-06,30.0,13,3400,16,10200,-6800,1200,35930
1268,2017-11-03,30.8,7,2400,20,10500,-8100,600,18510
1269,2017-11-02,31.1,13,2100,20,8700,-6600,1500,45970
1270,2017-11-01,31.7,15,3400,31,11400,-8000,1900,59620
1271,2017-10-31,32.3,11,5200,25,11000,-5800,4300,138890
1272,2017-10-30,31.4,6,1100,12,10300,-9200,500,15520
1273,2017-10-27,31.9,19,5400,30,13000,-7600,3100,97200
1274,2017-10-26,32.0,10,3300,13,8400,-5100,1600,50930
1275,2017-10-25,30.9,10,1700,9,4600,-2900,0,0
1276,2017-10-24,30.9,12,1500,16,9300,-7800,600,18280
1277,2017-10-23,30.9,11,1200,16,10400,-9200,400,12140
1278,2017-10-20,31.0,11,13700,20,7400,6300,2200,68440
1279,2017-10-19,30.4,13,12100,13,4800,7300,500,15030
1280,2017-10-18,30.7,14,12800,15,6200,6600,1500,45410
1281,2017-10-17,30.6,18,10200,20,8800,1400,500,15230
1282,2017-10-16,31.4,7,1100,18,10500,-9400,500,15260
1283,2017-10-13,31.5,6,3600,19,13400,-9800,1200,37760
1284,2017-10-12,31.6,10,16100,20,17700,-1600,11300,352810
1285,2017-10-11,31.6,14,2300,17,24700,-22400,700,21980
1286,2017-10-10,32.0,14,2300,18,23200,-20900,410,12834
1287,2017-10-09,32.2,24,6800,30,24400,-17600,4400,132770
1288,2017-10-06,32.5,21,18500,30,17900,600,4300,751880
1289,2017-10-05,31.9,9,2200,18,20900,-18700,1500,47540
1290,2017-10-04,31.9,9,1300,15,20400,-19100,540,17226
1291,2017-10-03,32.0,12,1900,19,28700,-26800,700,22520
1292,2017-10-02,32.3,14,2500,27,9100,-6600,600,19140
1293,2017-09-29,32.7,14,9300,35,29600,-20300,6500,212490
1294,2017-09-28,32.9,12,7800,17,8800,-1000,1700,55930
1295,2017-09-27,32.2,24,7000,47,39200,-32200,6500,201440
1296,2017-09-26,33.9,28,10600,49,51500,-40900,10300,327300
1297,2017-09-25,34.7,17,12700,36,48700,-36000,12100,386350
1298,2017-09-22,34.9,23,12500,30,42500,-30000,9900,326160
1299,2017-09-21,35.9,20,4300,25,30900,-26600,2310,82180
1300,2017-09-20,37.5,13,4600,31,14600,-10000,3600,134590
1301,2017-09-19,37.0,21,6300,40,20000,-13700,5000,186170
1302,2017-09-18,38.0,21,12600,29,11600,1000,9930,358597
1303,2017-09-15,35.4,7,4800,16,7000,-2200,3260,112416
1304,2017-09-14,34.0,6,1600,17,11600,-10000,300,10190
1305,2017-09-13,34.4,17,22100,39,29900,-7800,16500,1183520
1306,2017-09-12,32.0,14,3700,31,201400,-197700,1300,41700
1307,2017-09-11,31.9,15,4200,16,23400,-19200,2100,66770
1308,2017-09-08,31.9,13,9700,19,19800,-10100,1700,54190
1309,2017-09-07,31.5,14,9000,23,12800,-3800,1200,37570
1310,2017-09-06,31.4,9,4300,21,24200,-19900,1200,37440
1311,2017-09-05,31.8,8,2800,23,30600,-27800,2600,82390
1312,2017-09-01,32.9,8,5400,20,37400,-32000,1700,55640
1313,2017-08-31,33.0,25,29600,36,31600,-2000,14500,466830
1314,2017-08-30,30.5,24,25600,27,35400,-9800,11900,956050
1315,2017-08-29,29.5,11,14800,12,14900,-100,6204,187742
1316,2017-08-28,30.9,11,4700,16,16500,-11800,2800,86070
1317,2017-08-25,31.0,15,10000,17,30100,-20100,6600,188100
1318,2017-08-24,29.7,21,14100,11,16400,-2300,8400,232320
1319,2017-08-23,30.0,15,4700,15,8600,-3900,3300,95210
1320,2017-08-22,29.5,8,2200,10,9400,-7200,1200,35400
1321,2017-08-21,30.1,10,2400,19,15200,-12800,1400,40460
1322,2017-08-18,30.2,18,10200,32,13500,-3300,7900,229690
1323,2017-08-17,30.0,12,4000,12,12600,-8600,1500,45000
1324,2017-08-16,30.8,4,600,13,19500,-18900,300,9240
1325,2017-08-15,30.9,19,3900,35,24500,-20600,3400,101470
1326,2017-08-14,31.7,8,3700,15,10500,-6800,300,9620
1327,2017-08-11,31.0,47,67600,29,75400,-7800,67100,1895940
1328,2017-08-10,30.0,15,9300,11,9100,200,4000,118510
1329,2017-08-09,29.9,12,11100,19,33900,-22800,7300,213480
1330,2017-08-08,31.5,14,4900,11,14000,-9100,600,534700
1331,2017-08-07,30.0,12,9200,30,35900,-26700,2600,78120
1332,2017-08-04,32.4,7,6500,18,22100,-15600,2204,71410
1333,2017-08-03,31.0,9,9200,29,50800,-41600,7000,215460
1334,2017-08-02,32.3,5,1300,30,34400,-33100,700,22800
1335,2017-08-01,32.9,11,14700,31,39400,-24700,6700,210760
1336,2017-07-31,32.4,19,29900,35,42400,-12500,17500,551840
1337,2017-07-28,31.5,14,20500,16,25300,-4800,10010,305000
1338,2017-07-27,32.0,5,12200,18,19500,-7300,1000,32000
1339,2017-07-26,32.0,6,22600,20,23900,-1300,11000,350900
1340,2017-07-25,32.1,11,17600,33,25900,-8300,11400,364060
1341,2017-07-24,31.3,7,5400,11,7800,-2400,110,3443
1342,2017-07-21,29.0,12,23200,11,22700,500,15000,445810
1343,2017-07-20,28.4,10,7200,18,3700,3500,600,17330
1344,2017-07-19,29.0,26,22400,17,31100,-8700,14830,425637
1345,2017-07-18,31.4,9,6000,20,7400,-1400,729,22621
1346,2017-07-17,31.9,8,5800,18,16000,-10200,300,9480
1347,2017-07-14,32.2,18,10000,26,17300,-7300,2800,87160
1348,2017-07-13,33.0,7,1200,18,119400,-118200,20,660
1349,2017-07-12,33.0,9,7700,22,112900,-105200,0,0
1350,2017-07-11,33.0,23,27100,27,135900,-108800,24500,751652
1351,2017-07-10,33.9,14,12400,21,16800,-4400,5500,184250
1352,2017-07-07,33.0,18,27200,19,31300,-4100,1200,1230000
1353,2017-07-06,31.6,18,14700,20,24100,-9400,2700,85540
1354,2017-07-05,34.0,18,8100,23,104900,-96800,1500,47830
1355,2017-07-04,33.4,14,18400,23,18300,100,1450,46180
1356,2017-07-03,33.5,16,8300,22,25100,-16800,4300,145930
1357,2017-06-30,35.0,17,49400,21,31700,17700,25903,896760
1358,2017-06-29,32.5,13,10700,21,5400,5300,1400,45360
1359,2017-06-28,31.8,21,19000,21,24100,-5100,16900,2375590
1360,2017-06-27,32.5,12,3800,18,7200,-3400,3200,103980
1361,2017-06-26,31.2,18,19000,15,8200,10800,3623,113090
1362,2017-06-23,30.0,26,19700,26,26300,-6600,13328,405187
1363,2017-06-22,32.5,25,31800,18,33800,-2000,19600,613110
1364,2017-06-21,33.0,21,23000,24,41300,-18300,17100,562830
1365,2017-06-20,34.0,18,18000,15,29500,-11500,2800,92190
1366,2017-06-19,33.8,19,25700,17,27600,-1900,20300,673090
1367,2017-06-16,33.7,20,15600,25,30100,-14500,10000,332950
1368,2017-06-15,33.7,41,58300,27,60900,-2600,46210,1512910
1369,2017-06-14,33.9,23,10700,25,24300,-13600,9700,333460
1370,2017-06-13,36.3,30,19200,33,25100,-5900,7350,265655
1371,2017-06-12,36.0,27,23600,25,17000,6600,4400,854800
1372,2017-06-09,35.0,34,32200,32,13900,18300,7500,3605830
1373,2017-06-08,33.9,43,33700,28,20100,13600,12350,1130260
1374,2017-06-07,32.5,49,55000,30,35900,19100,24300,1709150
1375,2017-06-06,31.1,24,32500,22,25900,6600,16420,506540
1376,2017-06-05,31.0,25,28100,12,15000,13100,2900,88350
1377,2017-06-02,29.5,58,111100,59,74900,36200,65800,2021820
1378,2017-06-01,28.5,23,39700,37,64800,-25100,25200,750430
1379,2017-05-31,30.2,42,179400,48,45600,133800,45600,1327690
1380,2017-05-30,27.5,49,71100,80,90900,-19800,55500,1554210
1381,2017-05-29,28.5,18,31700,43,46000,-14300,26804,767744
1382,2017-05-26,30.0,20,33200,43,24900,8300,12300,932170
1383,2017-05-25,30.3,22,19600,42,25500,-5900,15500,449750
1384,2017-05-24,30.5,9,9100,24,11000,-1900,3801,883627
1385,2017-05-23,28.6,11,17000,25,15400,1600,9110,810688
1386,2017-05-22,26.0,31,39400,28,24600,14800,21212,3339971
1387,2017-05-19,24.5,49,58200,30,38500,19700,29900,727110
1388,2017-05-18,24.1,36,42900,40,42900,0,21400,685490
1389,2017-05-17,23.2,21,22700,41,34000,-11300,7600,181020
1390,2017-05-16,24.8,22,44400,40,35600,8800,27590,663408
1391,2017-05-15,23.2,43,53400,41,57700,-4300,30100,697830
1392,2017-05-12,25.0,46,91500,58,142700,-51200,73900,1796880
1393,2017-05-11,24.7,24,63200,25,37300,25900,9601,2296170
1394,2017-05-10,22.9,32,35000,39,62700,-27700,23904,558326
1395,2017-05-09,25.0,31,42900,46,69100,-26200,32222,776808
1396,2017-05-08,25.9,9,10300,20,14700,-4400,20,518
1397,2017-05-05,25.9,8,21500,21,17200,4300,12600,324034
1398,2017-05-04,25.9,14,15700,26,21400,-5700,6325,162641
1399,2017-05-03,25.7,20,19700,31,24000,-4300,10100,257550
1400,2017-04-28,25.5,54,65300,48,81800,-16500,57200,12223460
1401,2017-04-27,24.3,19,35200,30,33000,2200,6401,155544
1402,2017-04-26,24.3,29,46300,45,45300,1000,11800,295000
1403,2017-04-25,25.0,25,321600,26,323900,-2300,314100,8244672
1404,2017-04-24,25.5,19,32400,29,37400,-5000,13300,8092903
1405,2017-04-21,25.8,31,54600,40,49500,5100,23500,1905644
1406,2017-04-20,24.1,38,67100,64,84900,-17800,44131,16278514
1407,2017-04-19,25.3,13,35900,25,20200,15700,2600,65780
1408,2017-04-18,25.3,17,48900,33,36700,12200,16110,4914672
1409,2017-04-17,25.5,25,37500,30,34100,3400,12211,17550214
1410,2017-04-14,25.6,35,60300,41,37400,22900,23110,11420439
1411,2017-04-13,24.9,37,65900,29,36600,29300,24400,589650
1412,2017-04-12,24.0,28,55800,29,43000,12800,26406,620277
1413,2017-04-11,23.5,49,105100,74,102900,2200,79400,7861980
1414,2017-04-10,23.1,85,171200,73,153400,17800,141980,3274485
1415,2017-04-07,22.8,14,35300,28,48600,-13300,13320,756285
1416,2017-04-05,22.0,15,40500,29,66400,-25900,29400,658825
1417,2017-04-04,22.0,6,11200,17,32700,-21500,800,17700
1418,2017-04-03,22.0,11,21200,21,64300,-43100,18730,408951
1419,2017-03-31,24.2,14,55500,19,29500,26000,29500,644900
1420,2017-03-30,22.0,23,31400,30,50300,-18900,20370,2584251
1421,2017-03-29,22.0,22,53500,28,44000,9500,39556,846024
1422,2017-03-28,21.3,12,23200,23,50500,-27300,18300,363822
1423,2017-03-27,21.3,42,70900,25,55300,15600,29500,619205
1424,2017-03-24,20.7,54,82800,30,68500,14300,33900,694950
1425,2017-03-23,20.5,28,53900,24,44200,9700,23400,2558736
1426,2017-03-22,21.0,21,40800,29,93200,-52400,6600,140461
1427,2017-03-21,21.6,22,47900,34,53000,-5100,17200,371554
1428,2017-03-20,21.8,35,41300,33,36300,5000,22910,492794
1429,2017-03-17,21.7,44,68700,40,35300,33400,26400,563033
1430,2017-03-16,21.0,29,34200,27,29200,5000,10700,226530
1431,2017-03-15,21.1,36,57100,30,30600,26500,17200,2448298
1432,2017-03-14,20.0,29,50200,29,31200,19000,15730,325454
1433,2017-03-13,19.3,37,52200,48,65500,-13300,33911,682154
1434,2017-03-10,21.1,43,61500,49,91900,-30400,45240,936649
1435,2017-03-09,21.8,51,65700,62,104900,-39200,65850,1494597
1436,2017-03-08,23.5,49,92100,34,20500,71600,15250,353419
1437,2017-03-07,21.8,59,196200,42,61800,134400,61880,3097933
1438,2017-03-06,19.9,66,184400,38,71500,112900,52660,1021604
1439,2017-03-03,18.5,24,74500,28,57500,17000,25821,473970
1440,2017-03-02,18.0,48,86700,40,67700,19000,35269,2152745
1441,2017-03-01,17.0,28,63400,40,92800,-29400,38900,673398
1442,2017-02-28,17.8,22,79000,41,73200,5800,29700,532788
1443,2017-02-27,17.0,17,80800,21,36400,44400,20400,340129
1444,2017-02-24,15.6,26,127700,28,50700,77000,22000,343794
1445,2017-02-23,15.0,34,340200,50,103300,236900,73930,2381374
1446,2017-02-22,14.1,17,232300,21,63500,168800,12300,174143
1447,2017-02-21,14.1,19,170700,19,48200,122500,5600,79162
1448,2017-02-20,13.7,11,31000,36,75100,-44100,15410,223537
1449,2017-02-17,14.3,13,145600,40,137200,8400,83800,1804229
1450,2017-02-16,13.3,14,81500,30,71000,10500,23800,323014
1451,2017-02-15,13.6,16,99500,44,118500,-19000,38200,532355
1452,2017-02-14,14.2,23,105700,29,87000,18700,33600,1116058
1453,2017-02-13,13.9,21,71700,29,184500,-112800,18200,260933
1454,2017-02-10,14.5,23,26900,36,181400,-154500,20700,289945
1455,2017-02-09,13.6,23,33300,27,49700,-16400,20600,1887154
1456,2017-02-08,12.5,21,80100,23,31800,48300,14350,178241
1457,2017-02-07,11.5,19,138200,17,36200,102000,27600,323996
1458,2017-02-06,11.6,22,109300,33,93400,15900,39400,452430
1459,2017-02-03,11.7,24,117600,32,90600,27000,38500,4767678
1460,2017-02-02,11.7,23,86300,35,104200,-17900,58700,700526
1461,2017-01-25,12.5,21,76700,29,76500,200,59100,716233
1462,2017-01-24,12.0,13,53300,19,54400,-1100,41000,475805
1463,2017-01-23,11.5,25,39200,23,56900,-17700,29300,340407
1464,2017-01-20,11.7,23,60200,27,85500,-25300,39500,439635
1465,2017-01-19,11.0,18,66100,17,63800,2300,40900,444706
1466,2017-01-18,10.9,13,44500,18,50000,-5500,30900,888108
1467,2017-01-17,10.8,13,42600,24,78900,-36300,27900,302018
1468,2017-01-16,10.9,23,72200,21,82300,-10100,48200,521187
1469,2017-01-13,10.8,9,35400,21,89400,-54000,18000,192600
1470,2017-01-12,10.7,13,41900,18,103900,-62000,20500,216808
1471,2017-01-11,10.5,15,68800,12,47600,21200,34000,341428
1472,2017-01-10,10.1,11,40700,18,50500,-9800,19700,197000
1473,2017-01-09,10.0,16,44900,26,70100,-25200,34400,343656
1474,2017-01-06,9.9,20,39200,24,78900,-39700,20600,204517
1475,2017-01-05,10.0,28,45300,29,86100,-40800,35020,347433
1476,2017-01-04,10.0,27,53100,26,89700,-36600,36630,1016201
1477,2017-01-03,10.0,23,37800,15,62300,-24500,18200,177414
1478,2016-12-30,10.0,32,95600,27,95800,-200,76600,721649
1479,2016-12-29,9.3,29,50900,19,45600,5300,33700,306131
1480,2016-12-28,9.1,23,37500,21,53200,-15700,26030,233749
1481,2016-12-27,9.0,22,39600,18,55200,-15600,26300,236647
1482,2016-12-26,9.0,15,19400,10,32700,-13300,7600,244857
1483,2016-12-23,9.0,6,8600,8,14600,-6000,200,1800
1484,2016-12-22,9.0,7,24200,11,20500,3700,200,1800
1485,2016-12-21,8.9,10,30000,17,35900,-5900,6300,56095
1486,2016-12-20,8.9,9,25000,16,41600,-16600,1400,12410
1487,2016-12-19,9.0,12,36200,15,23200,13000,2000,17740
1488,2016-12-16,8.5,16,37700,12,26500,11200,2200,18680
1489,2016-12-15,8.3,11,16100,21,67000,-50900,12900,111250
1490,2016-12-14,8.7,8,7400,6,10200,-2800,200,1740
1491,2016-12-13,8.7,13,44200,12,15700,28500,3000,25860
1492,2016-12-12,8.4,11,28600,12,24100,4500,8000,440606
1493,2016-12-09,8.7,11,55400,6,18000,37400,240,2088
1494,2016-12-08,8.6,10,38900,10,17000,21900,3500,29082
1495,2016-12-07,8.4,9,37500,8,19000,18500,300,2580
1496,2016-12-06,8.4,10,37700,10,21200,16500,2700,21940
1497,2016-12-05,8.2,14,20000,19,53700,-33700,15400,123893
1498,2016-12-02,8.7,5,3400,7,22600,-19200,200,1740
1499,2016-12-01,8.7,15,5800,11,22000,-16200,4400,36419
1500,2016-11-30,8.7,10,35400,12,35100,300,3400,27900
1501,2016-11-29,8.5,13,40500,13,34500,6000,1400,11850
1502,2016-11-28,8.5,20,533600,18,501700,31900,495600,4212600
1503,2016-11-25,8.5,8,36900,13,20200,16700,6000,49740
1504,2016-11-24,8.5,6,3500,6,14600,-11100,500,4270
1505,2016-11-23,8.7,4,1100,14,51900,-50800,900,7785
1506,2016-11-22,9.2,8,33900,21,44900,-11000,700,6080
1507,2016-11-21,8.5,22,326600,27,325500,1100,293300,2502436
1508,2016-11-18,8.3,12,140400,25,184200,-43800,138400,1195776
1509,2016-11-17,8.8,5,2600,7,28100,-25500,200,1760
1510,2016-11-16,8.8,2,200,9,38200,-38000,200,1730
1511,2016-11-15,9.4,11,21000,16,65900,-44900,1400,12120
1512,2016-11-14,8.6,16,40900,17,43800,-2900,29600,251600
1513,2016-11-11,8.5,8,20700,8,23600,-2900,300,2550
1514,2016-11-10,8.5,9,21100,8,18300,2800,700,5950
1515,2016-11-09,8.5,11,24300,13,22300,2000,7000,56973
1516,2016-11-08,8.5,8,22700,7,14100,8600,300,2550
1517,2016-11-07,8.5,11,23500,12,20900,2600,1300,10990
1518,2016-11-04,8.5,10,23100,8,19700,3400,900,7650
1519,2016-11-03,8.6,12,26400,12,33300,-6900,2100,17919
1520,2016-11-02,8.5,9,22800,8,25200,-2400,400,3440
1521,2016-11-01,8.6,9,8400,12,24100,-15700,8400,68754
1522,2016-10-31,8.6,15,15700,13,29500,-13800,6370,54750
1523,2016-10-28,8.5,7,9800,6,12500,-2700,400,3440
1524,2016-10-27,8.5,8,6500,8,11700,-5200,1300,11083
1525,2016-10-26,8.6,6,5800,6,15200,-9400,200,1720
1526,2016-10-25,8.6,7,6800,6,10400,-3600,200,1720
1527,2016-10-24,8.7,12,14900,14,35000,-20100,1300,610913
1528,2016-10-21,8.4,10,8800,15,21900,-13100,2630,22826
1529,2016-10-20,8.7,19,16700,13,9000,7700,2300,19704
1530,2016-10-19,8.4,18,26200,18,14600,11600,6500,52871
1531,2016-10-18,8.2,11,26000,11,13500,12500,600,5160
1532,2016-10-17,8.0,15,36600,17,53700,-17100,22600,188778
1533,2016-10-14,8.6,18,46000,12,56400,-10400,12000,99948
1534,2016-10-13,8.6,9,46700,9,22400,24300,200,1720
1535,2016-10-12,8.5,9,46600,12,41700,4900,4600,39910
1536,2016-10-11,8.7,8,46200,12,26000,20200,1200,10500
1537,2016-10-10,8.7,9,48100,7,22800,25300,3100,27001
1538,2016-10-07,8.7,10,46500,9,36800,9700,2300,19930
1539,2016-10-06,8.6,11,50600,14,43100,7500,6200,53642
1540,2016-10-05,8.7,11,53700,13,54800,-1100,8700,75760
1541,2016-10-04,8.7,13,51200,19,55600,-4400,4300,37819
1542,2016-10-03,8.8,10,47600,14,31300,16300,1600,14310
1543,2016-09-30,8.8,19,50900,18,62500,-11600,2000,17694
1544,2016-09-29,8.7,10,49400,21,65000,-15600,2700,24030
1545,2016-09-28,9.0,17,53600,19,91700,-38100,6400,56403
1546,2016-09-27,9.0,11,34900,14,33600,1300,300,2680
1547,2016-09-26,9.1,9,47200,14,31600,15600,200,417690
1548,2016-09-23,9.0,16,52900,26,50300,2600,4500,39600
1549,2016-09-22,8.8,11,7900,21,43400,-35500,4100,37523
1550,2016-09-21,9.6,12,53500,23,46300,7200,4300,39242
1551,2016-09-20,8.9,14,50900,16,26400,24500,4600,40172
1552,2016-09-19,9.0,9,48000,14,26200,21800,1300,11400
1553,2016-09-16,9.0,10,48700,15,37200,11500,1200,10500
1554,2016-09-15,9.0,15,49400,22,42000,7400,8000,68848
1555,2016-09-14,9.0,11,20600,16,35400,-14800,4200,36742
1556,2016-09-13,9.2,9,32600,9,28200,4400,500,4600
1557,2016-09-12,9.1,11,34400,12,25900,8500,2300,20762
1558,2016-09-09,9.1,17,122100,22,117300,4800,89500,799772
1559,2016-09-08,9.1,23,113300,26,89100,24200,67300,596278
1560,2016-09-07,9.0,22,155200,22,181200,-26000,120900,1100190
1561,2016-09-06,9.1,20,69300,13,67700,1600,38400,855478
1562,2016-09-05,9.1,14,50500,16,48300,2200,2100,18690
1563,2016-09-01,9.0,17,44100,13,31700,12400,10900,96520
1564,2016-08-31,9.1,11,37700,19,57200,-19500,3200,28880
1565,2016-08-30,9.1,19,55800,23,41700,14100,8800,77845
1566,2016-08-29,9.0,21,56600,16,42200,14400,8000,70856
1567,2016-08-26,9.0,16,89900,25,122400,-32500,72500,639160
1568,2016-08-25,8.9,30,117200,40,159600,-42400,105200,927443
1569,2016-08-24,8.8,11,69800,16,22300,47500,22300,181901
1570,2016-08-23,8.3,11,184000,12,66900,117100,55740,638300
1571,2016-08-22,8.1,9,54100,16,65900,-11800,7100,722960
1572,2016-08-19,8.3,14,78300,17,36600,41700,9000,73800
1573,2016-08-18,8.2,11,35500,24,52900,-17400,22500,186030
1574,2016-08-17,8.3,13,40600,24,40500,100,18600,155515
1575,2016-08-16,8.3,15,41700,24,35800,5900,19600,161641
1576,2016-08-15,7.8,15,57300,13,22700,34600,9700,76746
1577,2016-08-12,7.3,4,4700,15,18800,-14100,300,2430
1578,2016-08-11,7.6,10,8400,17,39500,-31100,1700,13964
1579,2016-08-10,7.7,4,6500,12,27400,-20900,100,770
1580,2016-08-09,8.3,9,21100,14,30200,-9100,2600,20129
1581,2016-08-08,7.9,8,6700,11,14900,-8200,100,790
1582,2016-08-05,8.4,5,14800,15,39500,-24700,2200,16940
1583,2016-08-04,8.0,6,100,10,8100,-8000,100,800
1584,2016-08-03,7.6,10,23400,11,22300,1100,7400,56136
1585,2016-08-02,7.6,6,22100,9,6400,15700,1600,12320
1586,2016-08-01,7.8,8,24700,14,11300,13400,4300,33119
1587,2016-07-29,7.7,10,28200,18,28600,-400,7900,61233
1588,2016-07-28,8.0,7,4400,13,8100,-3700,1800,14357
1589,2016-07-27,8.6,15,32000,15,13100,18900,3700,29711
1590,2016-07-26,7.9,14,228600,8,13100,215500,6400,49920
1591,2016-07-25,7.8,21,238000,17,146500,91500,134600,1050822
1592,2016-07-22,7.9,26,237700,23,23200,214500,10600,83475
1593,2016-07-21,7.7,11,51300,30,34600,16700,27800,218147
1594,2016-07-20,7.9,8,31100,17,14300,16800,5700,44819
1595,2016-07-19,7.8,9,32700,24,18600,14100,7000,54950
1596,2016-07-18,7.7,11,44400,23,20500,23900,9400,73489
1597,2016-07-15,7.6,11,34100,19,13400,20700,5600,42879
1598,2016-07-14,7.5,11,42100,28,29300,12800,17100,127275
1599,2016-07-13,7.4,10,32200,25,19200,13000,7100,52867
1600,2016-07-12,7.3,10,31300,28,24000,7300,14100,103790
1601,2016-07-11,7.2,9,29600,24,19500,10100,8000,58168
1602,2016-07-08,7.2,19,46700,31,33400,13300,16700,118069
1603,2016-07-07,6.9,13,35900,20,26600,9300,13300,92369
1604,2016-07-06,6.9,15,30600,25,29700,900,8820,60911
1605,2016-07-05,6.9,11,19100,15,14600,4500,1400,9710
1606,2016-07-04,6.9,9,12200,21,16500,-4300,7600,51353
1607,2016-07-01,6.9,10,15300,16,16900,-1600,5500,37021
1608,2016-06-30,6.7,15,48600,24,38600,10000,28600,184956
1609,2016-06-29,6.2,15,31700,20,29900,1800,14200,89503
1610,2016-06-28,6.0,7,14800,11,11200,3600,2100,12550
1611,2016-06-27,6.0,2,5100,12,14600,-9500,0,0
1612,2016-06-24,6.0,4,8000,15,30400,-22400,3000,17586
1613,2016-06-23,6.1,40,141500,33,116500,25000,106000,626248
1614,2016-06-22,5.7,51,138200,39,160500,-22300,138000,801918
1615,2016-06-21,6.1,11,13600,9,32500,-18900,10500,64092
1616,2016-06-20,6.4,16,26200,17,49100,-22900,16700,106964
1617,2016-06-17,6.8,11,6100,9,11400,-5300,3400,22100
1618,2016-06-16,6.8,13,28000,17,48300,-20300,21600,144677
1619,2016-06-15,7.0,8,12300,19,23400,-11100,7200,50501
1620,2016-06-14,7.1,7,15500,14,16200,-700,5100,35700
1621,2016-06-13,7.1,12,29800,10,11600,18200,4200,29194
1622,2016-06-10,6.8,8,17300,14,25700,-8400,2900,20010
1623,2016-06-09,7.0,10,7100,13,8100,-1000,800,5570
1624,2016-06-08,7.1,5,8100,12,20800,-12700,0,0
1625,2016-06-07,7.1,12,14200,14,10800,3400,2000,14142
1626,2016-06-06,7.1,16,32900,15,18700,14200,13400,92889
1627,2016-06-03,7.0,13,9700,19,20900,-11200,3200,22589
1628,2016-06-02,7.4,13,11000,12,8400,2600,4420,31059
1629,2016-06-01,7.3,6,3100,16,20500,-17400,200,1460
1630,2016-05-31,7.4,24,34300,17,39300,-5000,30100,219850
1631,2016-05-30,7.2,11,33400,20,40400,-7000,26200,191260
1632,2016-05-27,7.5,43,151900,49,156900,-5000,148800,1089067
1633,2016-05-26,7.5,8,13300,11,9300,4000,5600,39200
1634,2016-05-25,7.5,4,2500,8,9900,-7400,0,0
1635,2016-05-24,7.5,3,1900,13,8300,-6400,0,0
1636,2016-05-23,7.5,7,12000,5,4500,7500,100,750
1637,2016-05-20,7.2,18,14600,14,13400,1200,5700,41188
1638,2016-05-19,7.6,7,2900,10,12200,-9300,0,0
1639,2016-05-18,7.6,9,37000,9,6800,30200,3100,22940
1640,2016-05-17,7.4,11,39700,13,10700,29000,2600,19760
1641,2016-05-16,7.6,9,14200,13,7500,6700,200,1480
1642,2016-05-13,7.8,22,43000,21,13200,29800,6200,47207
1643,2016-05-12,7.5,29,25000,19,27100,-2100,17300,129750
1644,2016-05-11,7.5,32,23500,30,27700,-4200,13020,97767
1645,2016-05-10,7.7,9,3500,17,16900,-13400,2800,21232
1646,2016-05-09,8.2,3,1700,13,16700,-15000,700,5740
1647,2016-05-06,8.2,11,8100,16,26000,-17900,6920,57415
1648,2016-05-05,8.6,5,3900,7,7000,-3100,800,6800
1649,2016-05-04,8.6,7,8400,10,7600,800,4100,35141
1650,2016-04-29,8.3,12,14000,15,12400,1600,5300,44849
1651,2016-04-28,8.5,21,10600,13,9000,1600,4300,35595
1652,2016-04-27,8.4,36,46900,34,57900,-11000,11800,102754
1653,2016-04-26,9.1,11,20000,23,51100,-31100,4000,36400
1654,2016-04-25,9.4,23,52200,34,81600,-29400,28500,262827
1655,2016-04-22,9.4,14,17500,28,56000,-38500,6500,61100
1656,2016-04-21,9.4,54,264300,36,203900,60400,125400,1153680
1657,2016-04-20,9.3,33,114600,39,71400,43200,20300,183634
1658,2016-04-19,9.4,89,180200,55,243100,-62900,126400,1166925
1659,2016-04-15,9.5,22,133300,28,121400,11900,27400,257834
1660,2016-04-14,9.5,59,109900,42,148600,-38700,84500,801736
1661,2016-04-13,9.5,29,47100,38,118800,-71700,28400,270141
1662,2016-04-12,9.6,65,220800,61,170000,50800,105600,983981
1663,2016-04-11,9.5,41,74600,56,150900,-76300,53200,510294
1664,2016-04-08,9.6,83,167700,57,244700,-77000,139000,1328562
1665,2016-04-07,9.6,74,146500,51,168100,-21600,110800,1035758
1666,2016-04-06,9.5,50,95400,47,230400,-135000,54700,520580
1667,2016-04-05,9.7,46,125400,76,213900,-88500,104100,1009770
1668,2016-04-04,9.7,51,152600,63,195600,-43000,95700,922357
1669,2016-04-01,9.6,50,159100,50,156400,2700,79100,744885
1670,2016-03-31,9.4,68,245900,73,286800,-40900,97300,920166
1671,2016-03-30,9.6,61,245400,55,209100,36300,102400,977203
1672,2016-03-29,9.5,43,114600,52,260700,-146100,68700,660757
1673,2016-03-28,9.8,138,413500,113,409200,4300,335900,3236732
1674,2016-03-25,9.6,64,300900,66,390400,-89500,223800,2125205
1675,2016-03-24,9.6,90,196000,69,284100,-88100,92200,885950
1676,2016-03-23,9.8,84,240000,49,151500,88500,108220,1011424
1677,2016-03-22,9.2,29,98600,42,203100,-104500,41800,388406
1678,2016-03-21,9.3,56,157400,36,211600,-54200,72200,677308
1679,2016-03-18,9.3,63,145800,49,212800,-67000,78500,736644
1680,2016-03-17,9.4,59,140000,51,210300,-70300,64800,618581
1681,2016-03-16,9.5,55,116300,31,145200,-28900,31700,299533
1682,2016-03-15,9.4,57,109000,29,114800,-5800,49514,470234
1683,2016-03-14,9.6,188,865700,64,869600,-3900,684700,6611463
1684,2016-03-11,9.6,64,194700,39,204800,-10100,91100,879844
1685,2016-03-10,9.8,74,181700,35,165700,16000,78300,767340
1686,2016-03-09,9.8,95,598100,83,679300,-81200,515114,5202651
1687,2016-03-08,10.1,50,264000,75,275200,-11200,98900,1002945
1688,2016-03-07,10.2,160,366700,68,257800,108900,166200,1666487
1689,2016-03-04,9.9,101,237700,52,183700,54000,97900,955112
1690,2016-03-03,9.6,80,250800,61,255600,-4800,161700,1527580
1691,2016-03-02,9.5,76,143300,39,193100,-49800,73700,700371
1692,2016-03-01,9.3,144,314500,82,382900,-68400,175200,1641974
1693,2016-02-29,9.4,147,491500,70,596000,-104500,258600,2461096
1694,2016-02-26,9.7,217,798800,63,700500,98300,460740,4422183
1695,2016-02-25,9.6,237,830500,100,923400,-92900,612500,6125000
1696,2016-02-24,10.0,252,968500,96,879900,88600,575900,5728477
1697,2016-02-23,10.0,276,677800,86,697100,-19300,457940,4724567
1698,2016-02-22,10.4,231,644100,78,643000,1100,475300,4970212
1699,2016-02-19,10.7,160,648900,86,618400,30500,457600,4776429
1700,2016-02-18,10.7,260,772100,97,625600,146500,399700,4155281
1701,2016-02-17,10.3,175,754000,91,754300,-300,457200,4715561
1702,2016-02-16,10.5,236,832600,84,656100,176500,484300,5096773
1703,2016-02-15,10.6,240,1136500,82,924000,212500,808300,8327107
1704,2016-02-05,10.5,61,180600,44,184600,-4000,108600,3874318
1705,2016-02-04,10.5,141,422300,51,291400,130900,243720,2559060
1706,2016-02-03,10.5,193,572200,64,347400,224800,299800,3080145
1707,2016-02-02,10.3,198,670200,78,446600,223600,345500,3569361
1708,2016-02-01,10.4,219,686500,66,456800,229700,361000,3747180
1709,2016-01-29,10.3,236,794700,87,742600,52100,616900,6402805
1710,2016-01-28,10.5,201,713200,115,487200,226000,378500,3936400
1711,2016-01-27,10.4,230,646700,95,537900,108800,373000,3879200
1712,2016-01-26,10.4,220,580400,90,476900,103500,349000,3543397
1713,2016-01-25,10.5,179,1051700,81,487600,564100,442600,4446360
1714,2016-01-22,9.7,213,1030100,125,756600,273500,671400,6385685
1715,2016-01-21,9.4,134,648700,84,646300,2400,439600,4096632
1716,2016-01-20,9.5,171,374300,55,372300,2000,223300,2143680
1717,2016-01-19,9.6,129,305600,85,271900,33700,230900,2131438
1718,2016-01-18,9.2,90,264900,93,417400,-152500,251900,2333854
1719,2016-01-15,9.9,191,736900,81,643600,93300,367500,3642660
1720,2016-01-14,10.0,228,952800,81,694100,258700,504200,4939647
1721,2016-01-13,10.0,265,1011300,74,805900,205400,652000,6523912
1722,2016-01-12,10.1,93,350000,45,233300,116700,174200,1723012
1723,2016-01-11,9.9,72,246300,33,215300,31000,131100,1295137
1724,2016-01-08,10.1,44,77300,53,205300,-128000,67500,696938
1725,2016-01-07,10.7,206,672000,71,598800,73200,512200,5355563
1726,2016-01-06,10.8,105,775200,71,547100,228100,409100,4355279
1727,2016-01-05,10.8,98,672400,74,615800,56600,409400,4411285
1728,2016-01-04,11.0,206,816100,92,741800,74300,417400,4600583
1729,2015-12-31,11.4,184,1057400,130,712000,345400,513100,5556360
1730,2015-12-30,11.1,162,460400,96,356400,104000,277200,2936657
1731,2015-12-29,10.6,114,390900,71,280900,110000,185900,1888744
1732,2015-12-28,10.1,110,450500,75,408800,41700,303700,2973527
1733,2015-12-25,9.8,151,586500,85,734900,-148400,385800,4359528
1734,2015-12-24,10.1,127,586600,71,554300,32300,453200,4570975
1735,2015-12-23,10.1,95,386100,69,393000,-6900,222600,2240914
1736,2015-12-22,10.2,198,674500,102,656800,17700,415200,4222999
1737,2015-12-21,10.2,180,690400,111,720700,-30300,445300,4596387
1738,2015-12-18,10.5,131,512400,88,476600,35800,319700,3330635
1739,2015-12-17,10.6,306,763700,122,708100,55600,454420,4820942
1740,2015-12-16,10.7,370,739300,122,578100,161200,449800,4781824
1741,2015-12-15,10.6,329,891900,134,686000,205900,527100,5443889
1742,2015-12-14,10.3,339,856400,136,732200,124200,501700,5127374
1743,2015-12-11,10.4,355,989600,272,786700,202900,607000,5986234
1744,2015-12-10,9.8,263,676300,206,810500,-134200,523100,5247216
1745,2015-12-09,10.2,179,863600,337,729500,134100,527100,5167688
1746,2015-12-08,9.8,115,748400,312,949100,-200700,619900,5821481
1747,2015-12-07,9.1,65,237200,166,295500,-58300,153700,1398824
1748,2015-12-04,9.2,69,276600,106,339900,-63300,186000,1729242
1749,2015-12-03,9.4,56,201800,76,224900,-23100,125400,1180892
1750,2015-12-02,9.4,58,234300,110,327000,-92700,122300,1169433
1751,2015-12-01,9.5,45,200400,69,319100,-118700,60100,571010
1752,2015-11-30,9.5,91,326800,217,461800,-135000,239540,2311561
1753,2015-11-27,9.9,81,192600,137,380400,-187800,158300,1598830
1754,2015-11-26,10.1,100,283400,95,368700,-85300,160900,1644559
1755,2015-11-25,10.3,114,315700,86,391400,-75700,200400,2071735
1756,2015-11-24,10.4,104,412600,120,583700,-171100,282400,2986098
1757,2015-11-23,10.7,157,569200,75,596900,-27700,318800,3404146
1758,2015-11-20,10.8,177,1045500,144,936600,108900,649100,7223185
1759,2015-11-19,11.2,230,1062800,147,815000,247800,634700,6910614
1760,2015-11-18,11.0,291,931000,128,727600,203400,610000,6581900
1761,2015-11-17,10.9,318,1238900,147,1183200,55700,893700,9767247
1762,2015-11-16,11.0,213,1242900,150,1029400,213500,840300,8943313
1763,2015-11-13,10.8,224,1186000,143,1074500,111500,761500,8235623
1764,2015-11-12,11.0,167,864400,132,797300,67100,564600,6124781
1765,2015-11-11,11.0,230,1143000,193,1031000,112000,810000,8803890
1766,2015-11-10,10.8,230,952700,130,851100,101600,700200,7421420
1767,2015-11-09,10.7,179,923900,119,807700,116200,637300,6754743
1768,2015-11-06,10.5,197,1041400,145,1114500,-73100,858100,9083847
1769,2015-11-05,10.8,172,651300,126,764100,-112800,525400,5823008
1770,2015-11-04,11.3,182,925700,153,985800,-60100,753430,8547663
1771,2015-11-03,11.4,206,1002900,145,862000,140900,710500,7913549
1772,2015-11-02,11.1,182,949400,186,989800,-40400,734500,8172782
1773,2015-10-30,11.2,200,1412500,258,1352400,60100,1084800,11584579
1774,2015-10-29,10.5,104,650200,194,783800,-133600,524600,5456889
1775,2015-10-28,10.2,72,248100,98,381100,-133000,164900,1682310
1776,2015-10-27,10.2,97,298500,176,672900,-374400,267000,2762382
1777,2015-10-26,10.6,116,484800,235,893300,-408500,427400,4668490
1778,2015-10-23,11.1,218,733600,172,963800,-230200,652400,7483028
1779,2015-10-22,11.5,279,1025600,151,1015000,10600,753030,8574000
1780,2015-10-21,11.5,244,804800,156,832300,-27500,557400,6302522
1781,2015-10-20,11.4,192,737700,145,884400,-146700,603600,6825509
1782,2015-10-19,11.5,243,1068700,142,942900,125800,740400,8444262
1783,2015-10-16,11.6,204,1145300,184,1184000,-38700,902500,10339943
1784,2015-10-15,11.4,208,963400,226,992500,-29100,719400,8134337
1785,2015-10-14,11.2,230,866400,166,1214600,-348200,753600,8567678
1786,2015-10-13,11.6,277,953200,126,997900,-44700,711470,8503052
1787,2015-10-12,11.8,409,1226100,193,1344200,-118100,1126900,13840586
1788,2015-10-09,12.7,361,1387100,209,1742100,-355000,1304720,16657360
1789,2015-10-08,13.1,225,1190400,169,878200,312200,720700,9161538
1790,2015-10-07,12.7,420,1797000,301,1656200,140800,1532100,18659446
1791,2015-10-06,12.4,409,2267300,264,1669100,598200,1561160,18562192
1792,2015-10-05,11.6,238,1173700,202,1048800,124900,747320,8655460
1793,2015-10-02,11.4,401,1714200,251,1668600,45600,1419600,16438968
1794,2015-10-01,11.6,237,1156900,207,1234500,-77600,980700,11175077
1795,2015-09-30,11.6,314,1503100,228,1388900,114200,1176448,13206805
1796,2015-09-29,11.5,175,1059700,142,774800,284900,578500,6501183
1797,2015-09-28,11.6,180,1190400,201,963300,227100,766600,8608151
1798,2015-09-25,11.3,281,1050500,167,935100,115400,760100,8555686
1799,2015-09-24,11.8,362,2129100,249,1716500,412600,1550830,17294856
1800,2015-09-23,11.0,256,1218000,152,922200,295800,780200,8379348
1801,2015-09-22,11.0,233,1094100,111,819600,274500,716700,7629988
1802,2015-09-21,10.8,163,771400,105,652200,119200,507300,5396657
1803,2015-09-18,10.8,176,845800,129,689300,156500,544600,5786375
1804,2015-09-17,10.5,118,931400,156,785300,146100,565000,5933630
1805,2015-09-16,10.5,101,694900,104,534100,160800,374900,3862220
1806,2015-09-15,10.4,132,997500,152,640100,357400,492100,5049438
1807,2015-09-14,10.1,73,362100,97,525000,-162900,270410,2684630
1808,2015-09-11,9.9,60,207800,85,356200,-148400,150520,1542679
1809,2015-09-10,10.3,136,623200,106,566900,56300,385700,3958053
1810,2015-09-09,10.3,72,424400,107,457300,-32900,236110,2426502
1811,2015-09-08,10.1,73,297200,81,418900,-121700,204510,2065960
1812,2015-09-07,9.9,78,222900,75,288900,-66000,159500,1591172
1813,2015-09-04,9.9,100,406100,63,492800,-86700,252100,2471336
1814,2015-09-03,9.8,79,269000,100,479000,-210000,170600,1665568
1815,2015-09-01,10.0,128,370500,85,407200,-36700,280600,2892425
1816,2015-08-31,10.6,89,691100,107,410700,280400,276030,2857463
1817,2015-08-28,10.5,131,723100,160,655400,67700,549800,5594765
1818,2015-08-27,10.0,102,487300,104,658600,-171300,375000,3594750
1819,2015-08-26,9.3,35,175800,50,317500,-141700,101100,926885
1820,2015-08-25,8.9,70,422000,71,713400,-291400,354800,3084276
1821,2015-08-24,8.7,46,187600,69,427900,-240300,128700,1142985
1822,2015-08-21,9.0,53,268500,85,494100,-225600,235900,2238219
1823,2015-08-20,9.6,70,371900,111,722600,-350700,329400,3226473
1824,2015-08-19,9.8,54,426900,118,527900,-101000,309100,2989306
1825,2015-08-18,9.6,62,344500,98,568100,-223600,291100,2784663
1826,2015-08-17,9.5,48,482700,158,642400,-159700,403700,3816176
1827,2015-08-14,9.4,64,367400,126,667400,-300000,291600,2730251
1828,2015-08-13,9.3,122,628300,119,858100,-229800,524500,4965442
1829,2015-08-12,9.4,117,733100,174,1030300,-297200,655300,6200449
1830,2015-08-11,9.3,81,217700,108,463400,-245700,198500,1880788
1831,2015-08-10,9.8,64,278200,79,496700,-218500,255800,2500957
1832,2015-08-07,9.8,72,208600,80,407500,-198900,176200,1721122
1833,2015-08-06,9.9,228,919100,151,1049200,-130100,693100,6830501
1834,2015-08-05,9.6,23,122000,61,150700,-28700,81100,778317
1835,2015-08-04,9.5,30,90600,46,81300,9300,45400,427986
1836,2015-08-03,9.3,29,109200,50,108700,500,52000,482196
1837,2015-07-31,9.4,23,83600,55,124400,-40800,55500,526695
1838,2015-07-30,9.5,37,111100,67,122800,-11700,52600,492546
1839,2015-07-29,9.3,31,166900,79,230000,-63100,128200,1194696
1840,2015-07-28,9.4,59,206100,102,290700,-84600,154400,1447500
1841,2015-07-27,9.5,47,183300,80,216200,-32900,103000,968200
1842,2015-07-24,9.5,54,170900,105,178000,-7100,105900,993766
1843,2015-07-23,9.5,96,228300,124,346100,-117800,177100,1707598
1844,2015-07-22,9.7,131,680900,154,751600,-70700,599500,5818148
1845,2015-07-21,9.9,186,520400,213,547500,-27100,379910,3772886
1846,2015-07-20,9.4,164,733400,173,491200,242200,491220,4530522
1847,2015-07-17,8.6,88,238800,124,353500,-114700,175900,1533496
1848,2015-07-16,8.7,160,467800,135,322300,145500,267200,2255702
1849,2015-07-15,8.3,79,283100,74,157600,125500,126600,1060275
1850,2015-07-14,8.6,254,747800,179,636800,111000,588200,4829710
1851,2015-07-13,8.8,218,429500,133,556400,-126900,429500,4032146
1852,2015-07-10,9.7,178,381300,125,448100,-66800,314700,3146056
1853,2015-07-09,10.3,180,323300,141,357500,-34200,251200,2651416
1854,2015-07-08,10.8,98,299000,94,274600,24400,152800,1688440
1855,2015-07-07,11.1,134,374300,117,271400,102900,188100,2087910
1856,2015-07-06,11.1,90,272100,88,234100,38000,132300,1478453
1857,2015-07-03,11.1,76,237900,78,186900,51000,92454,1048336
1858,2015-07-02,11.3,122,363600,126,305300,58300,156400,1747770
1859,2015-07-01,10.9,108,297000,100,245900,51100,145300,1606292
1860,2015-06-30,11.3,123,395100,124,407400,-12300,269800,3039837
1861,2015-06-29,11.3,136,384700,128,372700,12000,200400,2338449
1862,2015-06-26,11.6,147,494400,162,497500,-3100,370800,4301280
1863,2015-06-25,11.6,108,398900,127,372500,26400,222100,2570141
1864,2015-06-24,11.5,185,479300,155,473400,5900,285700,3375834
1865,2015-06-23,11.8,190,476500,184,398700,77800,247900,2891754
1866,2015-06-22,11.5,312,959700,212,946600,13100,711500,8327396
1867,2015-06-19,12.1,336,1235800,220,951800,284000,691500,8380980
1868,2015-06-18,12.3,485,1442100,250,1113400,328700,983430,12003747
1869,2015-06-17,11.8,288,802500,195,742800,59700,557400,6637519
1870,2015-06-16,12.4,360,1209600,233,889900,319700,671700,8372069
1871,2015-06-15,12.8,538,1701100,263,2070500,-369400,1701140,21864752
1872,2015-06-12,14.2,870,2463700,222,2320500,143200,2273300,30046206
1873,2015-06-11,14.3,529,2482400,226,2033300,449100,1962960,26711960
1874,2015-06-10,13.5,459,2066700,211,2080700,-14000,1868800,24955955
1875,2015-06-09,14.4,311,1234900,200,1374300,-139400,1099400,16063333
1876,2015-06-08,15.2,259,850300,158,853400,-3100,701200,10646320
1877,2015-06-05,15.4,369,1443900,166,1099400,344500,1016100,14801529
1878,2015-06-04,15.0,176,754700,151,763200,-8500,636400,9875019
1879,2015-06-03,15.3,167,675200,133,892200,-217000,675200,11061126
1880,2015-06-02,17.0,218,588600,116,575400,13200,491100,8446920
1881,2015-06-01,17.2,142,476800,103,476600,200,375980,6356318
1882,2015-05-29,16.9,146,554800,133,571700,-16900,504600,8672560
1883,2015-05-28,16.9,164,833000,102,520100,312900,520100,8579570
1884,2015-05-27,15.4,77,357500,60,376000,-18500,276534,4255582
1885,2015-05-26,15.6,76,447700,62,416300,31400,324500,5065770
1886,2015-05-25,15.8,96,579000,72,561600,17400,442200,6915124
1887,2015-05-22,16.0,105,574100,80,478400,95700,392200,6165776
1888,2015-05-21,15.9,138,682400,104,576700,105700,454800,7137176
1889,2015-05-20,16.3,247,660300,134,588400,71900,469600,7526749
1890,2015-05-19,15.7,128,489300,77,357400,131900,307800,4742275
1891,2015-05-18,15.4,167,384000,108,388300,-4300,276700,4265607
1892,2015-05-15,15.0,202,456100,108,404800,51300,325600,4845905
1893,2015-05-14,14.2,86,315300,44,290700,24600,198300,2783934
1894,2015-05-13,14.4,106,347500,59,320400,27100,261300,3709415
1895,2015-05-12,14.3,113,353900,65,338500,15400,256600,3662195
1896,2015-05-11,14.3,102,286100,40,265900,20200,203700,2888059
1897,2015-05-08,14.5,127,396300,73,328500,67800,243000,3478545
1898,2015-05-07,13.9,117,213900,54,205400,8500,141000,1949325
1899,2015-05-06,13.8,101,229600,76,242000,-12400,190500,2678621
1900,2015-05-05,14.0,78,200200,32,159100,41100,123500,1721220
1901,2015-05-04,14.1,78,174300,50,232700,-58400,136800,1952410
1902,2015-04-27,14.4,87,247500,48,200500,47000,112000,1614704
1903,2015-04-24,14.4,81,230500,48,227500,3000,153500,2214238
1904,2015-04-23,14.5,95,376100,74,367400,8700,219500,3179897
1905,2015-04-22,14.4,100,262500,47,286300,-23800,167200,2409686
1906,2015-04-21,14.5,96,358200,54,295100,63100,218700,3160652
1907,2015-04-20,14.4,79,281900,58,300200,-18300,167300,2406109
1908,2015-04-17,14.5,133,337500,55,330300,7200,207200,3015796
1909,2015-04-16,14.6,165,520300,75,423400,96900,260300,3794393
1910,2015-04-15,14.4,111,313900,48,339100,-25200,203800,2913729
1911,2015-04-14,14.4,108,311700,46,372600,-60900,186500,2687279
1912,2015-04-13,14.5,88,432800,63,410400,22400,258300,3758265
1913,2015-04-10,14.6,65,240500,55,200600,39900,102900,1497298
1914,2015-04-09,14.6,181,573400,75,433200,140200,353400,5044432
1915,2015-04-08,14.1,58,281400,76,278500,2900,162100,2272966
1916,2015-04-07,14.2,85,292800,41,223500,69300,127200,1782581
1917,2015-04-06,14.1,67,243600,98,289700,-46100,147700,2086853
1918,2015-04-03,14.1,114,466500,69,361500,105000,310200,4337216
1919,2015-04-02,14.1,84,433800,62,374600,59200,276800,3861083
1920,2015-04-01,14.1,76,210400,65,345000,-134600,184200,2732322
1921,2015-03-31,14.6,130,492000,80,455500,36500,281600,4082637
1922,2015-03-30,14.5,104,364200,58,370200,-6000,213000,3103410
1923,2015-03-27,14.5,69,446100,100,458200,-12100,318600,4689473
1924,2015-03-26,14.6,57,308300,51,279300,29000,150800,2224149
1925,2015-03-25,14.8,153,657900,92,532200,125700,418500,6189615
1926,2015-03-24,14.7,126,592800,89,471700,121100,281800,4138233
1927,2015-03-23,14.9,172,524600,115,690700,-166100,399800,6043377
1928,2015-03-20,15.4,254,964900,113,736700,228200,614200,9264593
1929,2015-03-19,15.2,224,905900,133,812900,93000,664512,10048750
1930,2015-03-18,15.3,337,1250400,138,1074600,175800,865300,13215727
1931,2015-03-17,15.1,206,953300,77,670400,282900,651300,9637937
1932,2015-03-16,14.7,90,493900,61,516000,-22100,367400,5439357
1933,2015-03-13,14.7,218,1359800,159,968500,391300,845100,12315642
1934,2015-03-12,14.6,233,579000,79,563600,15400,454300,6651406
1935,2015-03-11,14.7,178,433200,43,466500,-33300,356100,5206538
1936,2015-03-10,14.8,181,530900,66,538600,-7700,403812,5930787
1937,2015-03-09,14.6,151,469800,62,564000,-94200,374700,5499847
1938,2015-03-06,14.9,91,485100,162,488500,-3400,354900,5236904
1939,2015-03-05,14.9,241,589700,62,623400,-33700,461200,6829911
1940,2015-03-04,14.9,164,658100,92,690600,-32500,522100,7687400
1941,2015-03-03,14.8,156,520300,68,474300,46000,348000,5126736
1942,2015-03-02,14.7,162,619000,127,578500,40500,452800,6606351
1943,2015-02-27,14.7,269,573000,64,525600,47400,391700,5729396
1944,2015-02-26,14.8,122,448800,56,431000,17800,334200,4896698
1945,2015-02-25,14.9,189,567100,87,548900,18200,409500,6040535
1946,2015-02-24,14.9,92,268900,49,325300,-56400,202100,3010280
1947,2015-02-13,15.0,72,297500,67,306300,-8800,199200,2982622
1948,2015-02-12,15.1,149,496900,69,461800,35100,346800,5196451
1949,2015-02-11,15.0,104,314400,63,426700,-112300,256200,3833521
1950,2015-02-10,15.1,162,814400,88,569100,245300,411500,6160567
1951,2015-02-09,14.9,169,654800,129,674900,-20100,496700,7360597
1952,2015-02-06,14.7,110,454700,97,363300,91400,291900,4255902
1953,2015-02-05,14.6,158,478800,96,441000,37800,334800,4897454
1954,2015-02-04,14.6,141,430900,118,368700,62200,268500,3900231
1955,2015-02-03,14.6,93,261600,62,269500,-7900,175100,2576421
1956,2015-02-02,14.6,175,442900,112,405400,37500,290200,4222410
1957,2015-01-30,14.7,77,356800,87,330600,26200,189600,2779726
1958,2015-01-29,14.7,216,787300,111,658400,128900,591900,8599123
1959,2015-01-28,14.6,210,1012000,113,1014400,-2400,781800,11409589
1960,2015-01-27,14.6,88,427400,85,436100,-8700,285300,4240699
1961,2015-01-26,15.1,154,775500,111,616900,158600,371000,5570565
1962,2015-01-23,15.0,282,1215600,126,828600,387000,719800,10586818
1963,2015-01-22,14.5,166,587600,74,493700,93900,343300,4866964
1964,2015-01-21,14.4,119,531000,93,503000,28000,332300,4809710
1965,2015-01-20,14.4,144,367600,177,362900,4700,226900,3316597
1966,2015-01-19,14.5,223,660400,125,598400,62000,476300,7101633
1967,2015-01-16,15.6,205,558800,117,413000,145800,316534,4959455
1968,2015-01-15,16.0,204,744100,154,661900,82200,505500,7997010
1969,2015-01-14,15.7,166,724900,117,569500,155400,477800,7403989
1970,2015-01-13,15.3,203,808500,95,600900,207600,479800,7173490
1971,2015-01-12,14.5,67,328300,57,244800,83500,134400,1997184
1972,2015-01-09,15.1,110,442900,77,445000,-2100,295700,4460930
1973,2015-01-08,15.0,143,714300,93,821800,-107500,385100,5754934
1974,2015-01-07,14.8,86,377200,51,302800,74400,183800,2702411
1975,2015-01-06,14.7,174,845100,100,746600,98500,536800,7603235
1976,2015-01-05,14.6,126,558100,110,649000,-90900,362500,5345425
1977,2014-12-31,14.7,169,841500,118,718200,123300,499800,7218112
1978,2014-12-30,14.0,136,692500,94,576400,116100,365500,4997116
1979,2014-12-29,13.5,68,313400,87,491800,-178400,225500,3091605
1980,2014-12-26,13.7,65,457500,71,435000,22500,277216,3836669
1981,2014-12-25,14.0,93,493100,78,533800,-40700,306900,4310717
1982,2014-12-24,14.2,128,556100,98,601100,-45000,318000,4525458
1983,2014-12-23,14.2,119,583600,122,774200,-190600,388200,7765387
1984,2014-12-22,14.4,182,774400,137,715400,59000,459000,8426994
1985,2014-12-19,14.3,107,448700,85,600900,-152200,352300,7359763
1986,2014-12-18,15.8,254,1307700,186,1064700,243000,795084,13193876
1987,2014-12-17,15.7,201,871400,192,1316500,-445100,871400,13882273
1988,2014-12-16,17.4,160,946400,140,1177700,-231300,946400,17022897
1989,2014-12-15,19.3,390,2179500,137,1257000,922500,1257050,24787160
1990,2014-12-12,17.6,636,3225000,143,1564700,1660300,1564744,27925824
1991,2014-12-11,16.0,90,416200,80,604600,-188400,198800,3178812
1992,2014-12-10,16.0,89,432500,72,557400,-124900,243250,3893460
1993,2014-12-09,16.0,108,467400,64,519600,-52200,231900,3635496
1994,2014-12-08,15.7,95,500400,78,489700,10700,232400,3621722
1995,2014-12-05,15.4,97,400000,73,538400,-138400,215200,3294066
1996,2014-12-04,15.3,94,451900,68,595300,-143400,228500,3499249
1997,2014-12-03,15.4,91,536300,89,720400,-184100,313900,4839139
1998,2014-12-02,15.6,81,440700,62,588700,-148000,214000,6513594
1999,2014-12-01,15.9,210,838600,114,613600,225000,431600,6849924
2000,2014-11-28,15.5,129,767400,40,537700,229700,432300,6592575
2001,2014-11-27,15.2,74,679800,66,422900,256900,235800,3530869
2002,2014-11-26,15.0,73,573600,35,339000,234600,247300,3678588
2003,2014-11-25,14.9,62,488300,38,440900,47400,204300,3021393
2004,2014-11-24,14.9,84,448700,51,383600,65100,236700,3496296
2005,2014-11-21,14.9,40,362800,37,293300,69500,158200,2375215
2006,2014-11-20,15.3,125,691500,97,725100,-33600,442800,11320891
2007,2014-11-19,15.3,147,777500,85,587600,189900,475900,7209885
2008,2014-11-18,15.0,74,631300,102,645400,-14100,404144,11661352
2009,2014-11-17,15.1,148,638100,87,572600,65500,384400,5777532
2010,2014-11-14,14.8,93,469200,66,444100,25100,304300,4448562
2011,2014-11-13,14.7,126,547000,108,549200,-2200,420150,6217800
2012,2014-11-12,14.9,81,687700,70,673700,14000,390900,5783756
2013,2014-11-11,14.9,71,401300,66,427900,-26600,272300,4011524
2014,2014-11-10,14.9,109,598400,69,660400,-62000,335100,4980591
2015,2014-11-07,15.1,78,465800,63,553600,-87800,269100,4074443
2016,2014-11-06,15.3,161,845900,82,547400,298500,405410,6165070
2017,2014-11-05,14.8,162,901600,128,895400,6200,640384,9429654
2018,2014-11-04,14.6,105,731600,97,699400,32200,340184,4932328
2019,2014-11-03,14.6,108,454400,87,524900,-70500,267200,3987158
2020,2014-10-31,15.0,162,937200,110,608700,328500,498400,7319004
2021,2014-10-30,14.6,117,620400,95,509200,111200,265440,3898252
2022,2014-10-29,14.8,185,986300,94,681400,304900,568000,8255312
2023,2014-10-28,14.2,135,622600,88,563300,59300,378700,5344593
2024,2014-10-27,14.0,79,259900,94,411800,-151900,171410,2497787
2025,2014-10-24,15.2,139,582100,103,630600,-48500,380910,6676495
2026,2014-10-23,15.7,138,445100,133,661800,-216700,341920,5611249
2027,2014-10-22,16.9,308,1485000,140,709400,775600,709430,11448072
2028,2014-10-21,15.4,205,1272600,94,492300,780300,448260,6623042
2029,2014-10-20,14.2,91,499400,32,255800,243600,213200,2943652
2030,2014-10-17,13.6,49,246800,33,268100,-21300,148100,2030303
2031,2014-10-16,13.8,91,562000,60,527100,34900,394100,5498089
2032,2014-10-15,14.2,66,426400,55,355100,71300,234400,3311838
2033,2014-10-14,14.4,58,482300,51,279800,202500,200230,2872700
2034,2014-10-13,14.0,78,520700,48,319200,201500,265110,3629091
2035,2014-10-10,13.3,22,252100,40,237200,14900,104900,1404611
2036,2014-10-09,13.4,51,310300,44,176400,133900,111400,1469255
2037,2014-10-08,13.1,50,324600,59,259000,65600,148000,1919116
2038,2014-10-07,12.8,42,276400,43,166700,109700,72800,926453
2039,2014-10-06,12.5,37,223700,40,137000,86700,109800,1333850
2040,2014-10-03,12.2,18,118100,25,104000,14100,50700,621379
2041,2014-10-02,12.4,27,172200,29,146700,25500,112200,1359752
2042,2014-10-01,12.3,24,106600,26,91300,15300,87800,1706122
2043,2014-09-30,11.8,24,89000,19,67500,21500,52600,606478
2044,2014-09-29,11.4,15,55200,14,64500,-9300,44200,502289
2045,2014-09-26,11.3,25,179600,15,58000,121600,40100,453090
2046,2014-09-25,11.3,17,83100,22,66200,16900,48600,555304
2047,2014-09-24,11.6,19,69600,17,75400,-5800,39100,454616
2048,2014-09-23,11.5,21,81700,18,66300,15400,42000,506184
2049,2014-09-22,12.1,12,47800,12,62700,-14900,38500,472819
2050,2014-09-19,12.0,25,107000,20,87700,19300,53500,665059
2051,2014-09-18,12.6,18,65500,26,59700,5800,35500,450566
2052,2014-09-17,12.6,37,105300,30,65500,39800,49028,620351
2053,2014-09-16,12.0,49,103800,21,46100,57700,39600,460746
2054,2014-09-15,11.4,24,70200,17,32700,37500,24800,276644
2055,2014-09-12,10.7,25,56400,17,34900,21500,29200,311973
2056,2014-09-11,10.8,20,59300,16,41200,18100,36800,391846
2057,2014-09-10,10.7,18,67500,11,32900,34600,31700,333547
2058,2014-09-09,10.6,13,47400,14,35300,12100,27400,285700
2059,2014-09-08,10.9,24,58100,16,32900,25200,27000,292707
2060,2014-09-05,10.8,16,35900,17,30100,5800,17400,188268
2061,2014-09-04,10.7,17,28000,15,23200,4800,16500,172607
2062,2014-09-03,10.4,14,17200,12,16800,400,9700,98785
2063,2014-08-29,10.2,10,17800,6,11100,6700,10000,101200
2064,2014-08-28,10.3,18,27300,13,17400,9900,12500,122138
2065,2014-08-27,10.0,3,22700,5,7200,15500,2200,20900
2066,2014-08-26,10.0,6,25600,5,5200,20400,2000,20000
2067,2014-08-25,10.0,4,2000,1,9000,-7000,500,5000
2068,2014-08-22,9.6,3,700,4,24400,-23700,100,960
2069,2014-08-21,9.5,3,3100,2,3000,100,0,0
2070,2014-08-20,9.5,0,0,1,9000,-9000,0,0
2071,2014-08-19,9.5,2,300,0,0,300,0,0
2072,2014-08-18,9.5,5,2500,4,4800,-2300,2500,23875
2073,2014-08-15,10.5,1,1100,4,4300,-3200,0,0
2074,2014-08-14,10.5,5,1800,2,900,900,200,1740
2075,2014-08-13,9.6,1,200,1,300,-100,0,0
2076,2014-08-12,9.6,4,8400,3,1700,6700,100,960
2077,2014-08-11,10.0,7,13700,4,1800,11900,800,8150
2078,2014-08-08,10.5,4,6000,5,5000,1000,1700,18000
2079,2014-08-07,11.4,5,8500,5,3500,5000,500,5280
2080,2014-08-06,10.4,1,2000,6,2500,-500,900,9360
2081,2014-08-05,11.5,0,0,5,3500,-3500,0,0
2082,2014-08-04,11.5,0,0,5,2400,-2400,0,0
2083,2014-08-01,11.5,0,0,6,30900,-30900,0,0
2084,2014-07-31,11.5,0,0,6,21900,-21900,0,0
2085,2014-07-30,11.5,0,0,6,23400,-23400,0,0
2086,2014-07-29,11.5,0,0,3,900,-900,0,0
2087,2014-07-28,11.5,0,0,5,3700,-3700,0,0
2088,2014-07-25,11.5,3,700,3,1500,-800,500,5110
2089,2014-07-24,10.5,2,800,4,3200,-2400,800,8080
2090,2014-07-23,10.6,5,8600,2,1500,7100,1000,10600
2091,2014-07-22,10.8,6,5700,6,3200,2500,2000,21482
2092,2014-07-21,10.7,2,600,1,100,500,0,0
2093,2014-07-18,10.7,5,8100,3,800,7300,130,1391
2094,2014-07-17,11.5,2,5000,7,5700,-700,0,0
2095,2014-07-16,11.5,3,8000,7,12700,-4700,0,0
2096,2014-07-15,11.5,2,1300,3,800,500,0,0
2097,2014-07-14,11.5,2,6000,6,10700,-4700,0,0
2098,2014-07-11,11.5,5,8100,3,2400,5700,0,0
2099,2014-07-10,11.5,3,1400,5,13300,-11900,0,0
2100,2014-07-09,11.5,4,16300,4,4700,11600,70,805
2101,2014-07-08,11.5,4,8600,4,5200,3400,1500,17250
2102,2014-07-07,11.2,3,10600,5,3700,6900,600,6670
2103,2014-07-04,11.3,5,3200,6,3900,-700,1000,11300
2104,2014-07-03,11.5,8,7600,5,10500,-2900,5110,58765
2105,2014-07-02,11.5,2,2500,6,9600,-7100,900,10350
2106,2014-07-01,11.5,5,6000,3,3300,2700,200,2300
2107,2014-06-30,11.4,8,9500,3,6400,3100,100,1140
2108,2014-06-27,12.4,4,2000,5,7400,-5400,0,0
2109,2014-06-26,12.4,6,7300,7,8600,-1300,0,0
2110,2014-06-25,12.4,8,6100,4,7500,-1400,2300,26450
2111,2014-06-24,12.5,2,2400,6,9300,-6900,0,0
2112,2014-06-23,12.5,2,1100,8,17600,-16500,100,1250
2113,2014-06-20,13.0,0,0,4,16000,-16000,0,0
2114,2014-06-19,13.0,4,1800,1,4100,-2300,100,1300
2115,2014-06-18,12.0,6,10400,5,6500,3900,1000,12000
2116,2014-06-17,13.0,8,22100,5,15800,6300,11400,137096
2117,2014-06-16,13.0,3,8300,2,5100,3200,0,0
2118,2014-06-13,13.0,15,33500,12,19500,14000,11900,142503
2119,2014-06-12,13.0,8,22500,9,28500,-6000,3800,49400
2120,2014-06-11,13.0,6,17000,10,27500,-10500,0,0
2121,2014-06-10,13.0,14,15700,14,39600,-23900,4600,58162
2122,2014-06-09,13.0,15,30000,17,44600,-14600,11500,152755
2123,2014-06-06,13.5,3,1500,7,21600,-20100,0,0
2124,2014-06-05,13.5,13,17400,12,28700,-11300,6000,80300
2125,2014-06-04,13.5,7,8500,12,46800,-38300,2000,27000
2126,2014-06-03,13.5,12,34500,16,62000,-27500,17000,229700
2127,2014-06-02,13.2,3,8000,7,35000,-27000,3000,40200
2128,2014-05-30,13.6,5,7100,9,47100,-40000,3000,40800
2129,2014-05-29,14.0,1,3000,8,35100,-32100,0,0
2130,2014-05-28,14.0,1,5000,7,17100,-12100,0,0
2131,2014-05-27,14.0,2,2500,10,17800,-15300,0,0
2132,2014-05-26,14.0,7,10500,9,18200,-7700,5000,69800
2133,2014-05-23,14.0,18,33800,23,50300,-16500,25500,345820
2134,2014-05-22,14.1,9,14000,15,30300,-16300,3000,40900
2135,2014-05-21,14.0,9,15100,18,29400,-14300,7010,97638
2136,2014-05-20,13.9,17,43000,23,40900,2100,27180,369504
2137,2014-05-19,13.6,11,27200,13,43700,-16500,14000,188420
2138,2014-05-16,13.6,38,174300,38,167000,7300,153800,2044750
2139,2014-05-15,13.2,26,68100,20,73200,-5100,60700,776430
2140,2014-05-14,13.2,17,60500,19,96800,-36300,54000,707350
2141,2014-05-13,13.0,9,12600,10,14500,-1900,6500,83050
2142,2014-05-12,12.8,9,52000,15,70900,-18900,52000,668000
2143,2014-05-09,13.7,9,120500,17,150600,-30100,95000,1266000
2144,2014-05-08,13.1,8,87100,20,157900,-70800,87100,1148010
2145,2014-05-07,14.5,11,19500,13,16900,2600,4000,57000
2146,2014-05-06,14.4,11,34200,12,29200,5000,15000,215700
2147,2014-05-05,14.4,24,63300,17,51700,11600,42300,598890
2148,2014-04-29,14.3,26,72900,28,84500,-11600,73700,1029540
2149,2014-04-28,14.2,16,37900,25,62500,-24600,30300,428840
2150,2014-04-25,14.4,19,74000,22,62100,11900,50700,717170
2151,2014-04-24,14.2,15,48600,22,44600,4000,25800,360640
2152,2014-04-23,14.3,24,52500,28,67800,-15300,49100,685520
2153,2014-04-22,14.2,23,76500,26,64700,11800,55500,774700
2154,2014-04-21,14.0,26,80800,25,59800,21000,51600,700440
2155,2014-04-18,13.7,13,45300,26,58800,-13500,33800,459130
2156,2014-04-17,14.0,14,46700,15,37300,9400,27600,367300
2157,2014-04-16,13.2,6,4900,13,19600,-14700,3900,51260
2158,2014-04-15,13.9,20,63200,22,72600,-9400,47500,640810
2159,2014-04-14,13.6,27,89200,33,102500,-13300,55200,752620
2160,2014-04-11,14.1,29,85400,32,128800,-43400,57000,797370
2161,2014-04-10,14.0,9,24500,9,25700,-1200,8800,119826
2162,2014-04-08,13.5,11,24700,21,28000,-3300,15400,214900
2163,2014-04-07,14.2,9,24100,15,66100,-42000,10100,144450
2164,2014-04-04,14.1,5,25000,16,34300,-9300,8000,113900
2165,2014-04-03,14.8,11,28900,14,29400,-500,6900,7100950
2166,2014-04-02,14.5,14,55100,21,42100,13000,31630,432878
2167,2014-04-01,14.0,8,13800,20,28100,-14300,11600,161700
2168,2014-03-31,14.3,15,39500,25,42700,-3200,8900,126050
2169,2014-03-28,13.9,20,75600,23,26900,48700,16400,227070
2170,2014-03-27,13.6,17,70300,28,42800,27500,34500,460670
2171,2014-03-26,13.5,18,96800,36,75500,21300,47700,635560
2172,2014-03-25,13.4,21,74400,38,56600,17800,27200,359180
2173,2014-03-24,13.1,24,52000,30,46200,5800,33300,429000
2174,2014-03-21,13.0,21,77700,24,52100,25600,33000,421960
2175,2014-03-20,12.5,8,18200,27,44000,-25800,13000,166970
2176,2014-03-19,13.0,8,32800,15,17200,15600,7200,93600
2177,2014-03-18,13.0,10,42900,28,47000,-4100,23300,301250
2178,2014-03-17,12.6,12,36900,22,33900,3000,23500,294220
2179,2014-03-14,12.5,7,22300,18,19600,2700,4200,52140
2180,2014-03-13,12.5,10,49500,15,20300,29200,8300,103340
2181,2014-03-12,12.2,11,14500,11,34200,-19700,9400,114900
2182,2014-03-11,12.9,16,42100,23,65400,-23300,20200,253600
2183,2014-03-10,13.2,12,42600,25,62500,-19900,19600,256460
2184,2014-03-07,13.3,11,56800,43,80600,-23800,40600,536420
2185,2014-03-06,13.1,16,78500,34,80300,-1800,43300,559830
2186,2014-03-05,12.9,8,27500,19,58800,-31300,23500,300050
2187,2014-03-04,12.9,18,72100,31,86500,-14400,58100,733100
2188,2014-03-03,12.8,21,71800,34,90300,-18500,66000,807110
2189,2014-02-28,12.9,17,65400,37,80000,-14600,39300,495110
2190,2014-02-27,12.9,34,181400,85,189700,-8300,133200,1693520
2191,2014-02-26,12.9,36,144200,50,94000,50200,94000,1165240
2192,2014-02-25,11.8,19,77700,52,74400,3300,37100,437780
2193,2014-02-24,11.5,20,133800,29,48700,85100,28800,329440
2194,2014-02-21,11.0,14,82500,22,57600,24900,32900,353710
2195,2014-02-20,10.9,20,54300,39,97900,-43600,36700,399290
2196,2014-02-19,11.7,13,79800,25,68400,11400,7600,89120
2197,2014-02-18,11.4,26,155600,43,99500,56100,47300,526949
2198,2014-02-17,11.1,80,337700,44,146100,191600,115900,1295950
2199,2014-02-14,10.2,29,177300,23,48900,128400,20500,205910
2200,2014-02-13,10.1,11,54300,19,68300,-14000,19200,193300
2201,2014-02-12,10.1,9,51000,22,58500,-7500,18000,180700
2202,2014-02-11,10.0,13,33900,17,31100,2800,15600,156170
2203,2014-02-10,10.0,7,16100,19,50100,-34000,4900,48510
2204,2014-02-07,10.1,18,27500,16,16100,11400,8700,85330
2205,2014-02-06,10.2,8,35400,11,10900,24500,2300,22310
2206,2014-01-27,9.5,21,54500,6,9700,44800,6500,61720
2207,2014-01-24,8.8,16,74600,10,17100,57500,7100,63500
2208,2014-01-23,9.0,23,100100,10,65600,34500,30600,1676809
2209,2014-01-22,9.1,18,34300,10,63700,-29400,4300,39190
2210,2014-01-21,9.4,7,11500,11,68500,-57000,4300,40220
2211,2014-01-20,9.9,6,23600,14,67300,-43700,15100,147060
2212,2014-01-17,10.0,12,67300,17,62100,5200,13200,2826880
2213,2014-01-16,10.0,9,59500,29,94700,-35200,21000,210300
2214,2014-01-15,10.2,4,16500,13,68500,-52000,0,0
2215,2014-01-14,10.2,7,17300,21,77800,-60500,10500,107060
2216,2014-01-13,10.2,5,40000,25,80500,-40500,25000,256000
2217,2014-01-10,10.4,15,37000,24,47700,-10700,19200,199960
2218,2014-01-09,10.0,14,38700,35,59100,-20400,22200,230430
2219,2014-01-08,10.5,13,23400,21,74900,-51500,12700,133560
2220,2014-01-07,10.8,20,27900,18,23600,4300,8800,94687
2221,2014-01-06,10.3,20,37300,33,76300,-39000,32100,333622
2222,2014-01-03,11.3,29,45400,35,63000,-17600,16700,187330
2223,2014-01-02,11.4,21,48700,33,94400,-45700,11200,127260
2224,2013-12-31,11.9,25,78000,40,90700,-12700,12600,146030
2225,2013-12-30,11.3,28,75900,36,114700,-38800,45100,511120
2226,2013-12-27,11.5,38,135400,44,72200,63200,57500,645800
2227,2013-12-26,10.6,42,144900,30,51500,93400,40800,416790
2228,2013-12-25,9.8,38,133500,27,94600,38900,81500,779340
2229,2013-12-24,9.4,37,65200,24,103600,-38400,45600,427820
2230,2013-12-23,9.4,9,31200,30,82300,-51100,18000,170500
2231,2013-12-20,9.5,12,67500,20,108400,-40900,14100,133090
2232,2013-12-19,9.5,17,51800,26,103100,-51300,34000,325000
2233,2013-12-18,9.6,18,77600,22,66700,10900,26600,255060
2234,2013-12-17,9.6,19,65000,34,140500,-75500,24400,231170
2235,2013-12-16,9.6,16,64800,30,111800,-47000,51000,480000
2236,2013-12-13,9.7,10,37100,55,73100,-36000,12100,118720
2237,2013-12-12,9.4,7,26600,20,54800,-28200,7600,71260
2238,2013-12-11,9.4,10,29100,29,80800,-51700,17600,162380
2239,2013-12-10,9.4,16,34700,26,70700,-36000,22600,205650
2240,2013-12-09,9.3,12,40800,30,160500,-119700,20400,190240
2241,2013-12-06,9.5,12,40200,20,48400,-8200,18900,178610
2242,2013-12-05,9.4,12,34700,22,75100,-40400,9000,84600
2243,2013-12-04,9.4,20,50800,31,147000,-96200,36300,330380
2244,2013-12-03,9.4,28,108800,31,207100,-98300,83900,769440
2245,2013-12-02,9.3,23,77100,27,117100,-40000,18300,173040
2246,2013-11-29,9.0,41,109600,42,80400,29200,58700,513270
2247,2013-11-28,8.3,11,51500,26,87800,-36300,8000,66740
2248,2013-11-27,8.2,16,75900,39,174300,-98400,70600,590630
2249,2013-11-26,8.7,15,72600,34,128200,-55600,26600,2834420
2250,2013-11-25,8.7,12,88500,28,68200,20300,46900,403970
2251,2013-11-22,8.7,12,59300,13,23200,36100,7000,60700
2252,2013-11-21,8.6,17,97100,23,41400,55700,31300,263630
2253,2013-11-20,8.5,13,53500,26,28100,25400,23000,193660
2254,2013-11-19,8.3,15,57300,21,52500,4800,24500,198280
2255,2013-11-18,8.3,11,66800,19,80400,-13600,63700,484640
2256,2013-11-15,8.2,26,97400,27,48000,49400,29000,237990
2257,2013-11-14,8.2,17,84700,22,33000,51700,18300,149040
2258,2013-11-13,8.0,19,111600,21,59800,51800,38000,300710
2259,2013-11-12,7.9,16,89900,21,39200,50700,21500,168100
2260,2013-11-11,7.9,16,68300,22,36100,32200,9800,76120
2261,2013-11-08,8.0,22,82300,20,52500,29800,20500,160070
2262,2013-11-07,7.8,18,102500,59,135700,-33200,80600,600170
2263,2013-11-06,7.8,20,113500,48,114000,-500,54700,425140
2264,2013-11-05,8.2,26,96100,42,92900,3200,40940,324200
2265,2013-11-04,7.7,32,174000,35,82500,91500,77700,586520
2266,2013-11-01,7.0,25,128100,35,61000,67100,21500,149600
2267,2013-10-31,6.8,23,166800,42,111400,55400,70200,462590
2268,2013-10-30,6.4,21,135000,38,81400,53600,33900,218430
2269,2013-10-29,6.4,19,98100,31,87300,10800,38500,242590
2270,2013-10-28,6.3,28,144900,47,106600,38300,48900,514240
2271,2013-10-25,6.2,18,127500,53,314800,-187300,47500,293634
2272,2013-10-24,6.2,18,97100,50,133500,-36400,62000,377200
2273,2013-10-23,6.0,32,225000,52,183000,42000,121000,718100
2274,2013-10-22,6.0,24,110300,46,120900,-10600,54800,322700
2275,2013-10-21,5.7,45,231000,61,154400,76600,152400,861080
2276,2013-10-18,5.2,15,105500,32,66300,39200,29300,153910
2277,2013-10-17,5.3,14,104200,34,88300,15900,31000,163100
2278,2013-10-16,5.2,9,95000,19,42900,52100,28200,145020
2279,2013-10-15,5.0,15,111900,27,61600,50300,40800,203900
2280,2013-10-14,4.9,9,90300,20,45200,45100,19900,97510
2281,2013-10-11,5.0,9,99100,15,98300,800,60000,293010
2282,2013-10-10,4.8,11,118300,16,65300,53000,26600,127680
2283,2013-10-09,4.9,12,74100,13,46500,27600,9100,44190
2284,2013-10-08,5.0,14,109800,17,55700,54100,29100,141500
2285,2013-10-07,5.0,21,147800,15,89900,57900,61300,294260
2286,2013-10-04,4.8,8,74000,12,49400,24600,8000,38400
2287,2013-10-03,4.8,15,111000,18,49300,61700,27000,131700
2288,2013-10-02,5.0,13,50800,15,48300,2500,14400,71000
2289,2013-10-01,5.0,13,49700,23,76200,-26500,37500,187530
2290,2013-09-30,5.1,24,139700,23,125600,14100,95100,465560
2291,2013-09-27,4.7,11,49600,13,57200,-7600,30600,143820
2292,2013-09-26,4.7,7,29700,10,55600,-25900,13500,63450
2293,2013-09-25,4.7,15,50500,21,75600,-25100,32900,156910
2294,2013-09-24,4.7,17,70300,18,97300,-27000,70300,330440
2295,2013-09-23,5.2,7,13100,12,45900,-32800,2200,10620
2296,2013-09-20,4.9,10,73000,9,93900,-20900,60800,290970
2297,2013-09-19,4.7,7,33000,5,14000,19000,10000,47000
2298,2013-09-18,4.7,6,22000,9,38800,-16800,22000,103600
2299,2013-09-17,5.2,14,61500,13,57400,4100,36500,170990
2300,2013-09-16,4.9,5,4200,13,46100,-41900,4100,20190
2301,2013-09-13,5.3,13,43800,25,70700,-26900,30200,154550
2302,2013-09-12,5.2,5,11100,11,27200,-16100,7100,36320
2303,2013-09-11,5.0,6,11800,11,18700,-6900,10400,1008000
2304,2013-09-10,5.0,10,19900,18,42800,-22900,13200,66050
2305,2013-09-09,5.3,7,10500,21,42900,-32400,4100,21250
2306,2013-09-06,5.2,8,22300,25,40500,-18200,11100,58010
2307,2013-09-05,5.2,9,30700,32,57800,-27100,14900,79600
2308,2013-09-04,5.2,6,10200,42,78100,-67900,3200,16690
2309,2013-09-03,5.6,6,23300,38,70700,-47400,7000,37600
2310,2013-08-30,5.2,12,45800,20,47800,-2000,28000,143120
2311,2013-08-29,5.1,15,53800,38,91100,-37300,31800,163370
2312,2013-08-28,5.1,12,41400,25,47700,-6300,23300,117710
2313,2013-08-27,5.0,6,20000,16,32800,-12800,4600,22740
2314,2013-08-26,5.0,11,39100,33,69000,-29900,30500,152250
2315,2013-08-23,4.9,5,15200,20,38100,-22900,5200,25990
2316,2013-08-22,5.0,16,55100,23,41800,13300,36100,180200
2317,2013-08-21,4.6,10,48800,10,27600,21200,22000,102000
2318,2013-08-20,4.5,7,22800,14,24900,-2100,11000,50580
2319,2013-08-19,4.6,6,21600,7,31000,-9400,15000,69000
2320,2013-08-16,4.6,7,34600,8,31500,3100,24000,110400
2321,2013-08-15,4.6,11,24000,17,43800,-19800,17400,81900
2322,2013-08-14,4.8,6,21400,4,11400,10000,1100,5300
2323,2013-08-13,4.6,8,23300,13,14200,9100,10500,47910
2324,2013-08-12,4.5,7,33600,11,38100,-4500,26000,119200
2325,2013-08-09,4.6,6,23600,12,23700,-100,11000,50600
2326,2013-08-08,4.6,6,7600,13,20500,-12900,2000,9200
2327,2013-08-07,4.8,7,28600,12,26600,2000,5300,25440
2328,2013-08-06,4.8,11,45100,11,23400,21700,6900,32440
2329,2013-08-05,4.7,9,31700,13,28300,3400,3100,14570
2330,2013-08-02,4.9,6,34000,13,40800,-6800,6300,30870
2331,2013-08-01,5.2,7,37000,15,33600,3400,400,2080
2332,2013-07-31,5.1,5,29500,16,37300,-7800,0,0
2333,2013-07-30,5.1,10,45100,14,21700,23400,4600,22510
2334,2013-07-29,5.0,7,40800,16,35700,5100,8500,42500
2335,2013-07-26,5.1,20,25500,23,54300,-28800,20700,105450
2336,2013-07-25,5.1,17,43300,19,46800,-3500,31300,159440
2337,2013-07-24,5.0,20,44500,22,61100,-16600,26800,134000
2338,2013-07-23,5.1,20,57400,28,72700,-15300,41900,205690
2339,2013-07-22,5.1,21,54200,26,45800,8400,12200,62780
2340,2013-07-19,5.1,37,76000,64,198300,-122300,72900,374480
2341,2013-07-18,5.6,39,133200,83,248400,-115200,84200,500820
2342,2013-07-17,5.6,49,377100,41,140800,236300,140800,786760
2343,2013-07-16,5.1,55,301600,56,219700,81900,219700,1097970
2344,2013-07-15,4.7,23,152300,37,144700,7600,75300,349140
2345,2013-07-12,4.6,13,77600,32,137400,-59800,65000,298010
2346,2013-07-11,4.5,11,29700,20,88300,-58600,6500,28850
2347,2013-07-10,4.5,13,34000,20,44600,-10600,4400,20060
2348,2013-07-09,4.6,11,36000,11,29000,7000,11000,49600
2349,2013-07-08,4.5,11,31800,21,54800,-23000,5900,26370
2350,2013-07-05,4.5,14,37200,16,63300,-26100,17700,79430
2351,2013-07-04,4.5,10,43700,16,49300,-5600,7000,31300
2352,2013-07-03,4.5,15,29000,18,72600,-43600,23400,103170
2353,2013-07-02,4.5,18,36000,24,86800,-50800,14400,434295
2354,2013-07-01,4.5,9,24000,25,101400,-77400,15900,70240
2355,2013-06-28,4.6,6,14300,21,88200,-73900,1300,5980
2356,2013-06-27,4.6,9,45900,24,77200,-31300,20700,93250
2357,2013-06-26,4.4,10,36200,11,31600,4600,2000,579160
2358,2013-06-25,4.3,15,50200,45,132600,-82400,48000,209150
2359,2013-06-24,4.6,15,38900,32,119400,-80500,12400,55710
2360,2013-06-21,4.6,12,18900,30,113000,-94100,9700,43850
2361,2013-06-20,4.5,18,39700,37,118700,-79000,4500,20810
2362,2013-06-19,4.7,29,58300,40,105100,-46800,30400,139950
2363,2013-06-18,4.5,35,108300,42,122100,-13800,55100,1452320
2364,2013-06-17,4.2,7,30300,26,155300,-125000,10100,42930
2365,2013-06-14,4.3,14,36400,32,111300,-74900,21000,89000
2366,2013-06-13,4.4,21,67000,45,152900,-85900,50100,218190
2367,2013-06-12,4.3,9,38000,33,96700,-58700,25700,109890
2368,2013-06-11,4.4,16,89900,55,171500,-81600,58700,252630
2369,2013-06-10,4.4,39,124900,65,246400,-121500,72200,313970
2370,2013-06-07,4.2,68,185800,51,133300,52500,71900,298780
2371,2013-06-06,3.9,11,28500,25,77000,-48500,13300,51870
2372,2013-06-05,3.9,10,42500,23,52900,-10400,22300,86970
2373,2013-06-04,3.9,8,20700,37,83100,-62400,15600,60840
2374,2013-06-03,3.9,22,88700,45,141800,-53100,28700,112320
2375,2013-05-31,3.9,11,51100,34,88700,-37600,33700,127710
2376,2013-05-30,3.8,7,31000,33,87600,-56600,20200,75340
2377,2013-05-29,3.8,10,52200,45,134100,-81900,52200,196640
2378,2013-05-28,3.8,6,21800,34,104000,-82200,12600,429419
2379,2013-05-27,3.8,13,33900,29,86400,-52500,13700,50710
2380,2013-05-24,3.6,14,64300,23,59900,4400,34700,123980
2381,2013-05-23,3.5,13,75800,39,120500,-44700,63600,222600
2382,2013-05-22,3.5,6,28600,34,121100,-92500,16000,56000
2383,2013-05-21,3.6,9,25800,24,99900,-74100,5500,464805
2384,2013-05-20,3.5,8,16200,23,75600,-59400,700,2520
2385,2013-05-17,3.5,10,64800,37,89000,-24200,32000,112000
2386,2013-05-16,3.5,7,27500,29,106600,-79100,13000,45200
2387,2013-05-15,3.6,15,142600,45,172200,-29600,128800,452020
2388,2013-05-14,3.5,22,78300,40,145600,-67300,60200,204690
2389,2013-05-13,3.4,12,47500,30,94000,-46500,30300,102080
2390,2013-05-10,3.4,24,30800,26,76400,-45600,13700,575581
2391,2013-05-09,3.3,9,27800,18,79000,-51200,10600,34287
2392,2013-05-08,3.3,11,62900,25,52600,10300,16500,52200
2393,2013-05-07,3.3,16,79800,47,141100,-61300,75200,248180
2394,2013-05-06,3.3,11,23100,24,76500,-53400,700,2300
2395,2013-05-03,3.3,9,38900,17,63000,-24100,13700,451360
2396,2013-05-02,3.2,12,62500,30,115800,-53300,29300,93760
2397,2013-04-26,3.3,16,65900,35,93400,-27500,52200,171390
2398,2013-04-25,3.2,18,104500,40,126000,-21500,83500,263870
2399,2013-04-24,3.0,9,56500,22,93100,-36600,47300,141900
2400,2013-04-23,3.0,15,55100,26,87400,-32300,48900,589170
2401,2013-04-22,3.0,16,69000,23,85900,-16900,59600,178800
2402,2013-04-18,3.0,14,56000,18,68700,-12700,50000,150000
2403,2013-04-17,3.0,21,56500,23,73500,-17000,30000,90000
2404,2013-04-16,3.0,16,66600,24,53500,13100,38000,111900
2405,2013-04-15,3.0,19,70800,40,122400,-51600,53800,548571
2406,2013-04-12,3.0,13,64000,35,106800,-42800,38800,116400
2407,2013-04-11,3.1,12,45400,23,37100,8300,6100,18210
2408,2013-04-10,3.0,15,69100,35,81900,-12800,50100,150310
2409,2013-04-09,3.0,22,80800,28,68700,12100,26000,524020
2410,2013-04-08,3.0,15,73000,31,110800,-37800,57900,173700
2411,2013-04-05,3.1,31,82800,33,73200,9600,25800,735026
2412,2013-04-04,3.1,35,140900,37,119500,21400,83100,245020
2413,2013-04-03,3.1,29,120100,49,125800,-5700,92800,706791
2414,2013-04-02,3.1,37,164800,83,282500,-117700,159300,490070
2415,2013-04-01,3.1,15,80000,32,87000,-7000,61900,190610
2416,2013-03-29,3.0,16,48200,39,82600,-34400,28000,84000
2417,2013-03-28,3.1,17,69100,33,100000,-30900,46100,138310
2418,2013-03-27,3.0,18,33100,42,83000,-49900,21100,63310
2419,2013-03-26,3.1,24,71100,41,112600,-41500,57200,174990
2420,2013-03-25,3.0,43,179500,42,203300,-23800,151800,455400
2421,2013-03-22,2.9,19,67600,51,115700,-48100,45900,135910
2422,2013-03-21,3.0,18,60900,30,78900,-18000,31100,93300
2423,2013-03-20,2.9,27,119300,19,23800,95500,8700,24980
2424,2013-03-19,2.9,13,91700,34,109300,-17600,54500,157200
2425,2013-03-18,2.9,17,53900,25,72600,-18700,17200,49880
2426,2013-03-15,2.9,36,103600,30,106000,-2400,66200,192680
2427,2013-03-14,2.8,29,55400,22,76200,-20800,27100,74420
2428,2013-03-13,2.8,17,34700,25,42800,-8100,2700,7610
2429,2013-03-12,2.9,22,63200,62,252600,-189400,56600,164940
2430,2013-03-11,3.1,28,78000,47,118800,-40800,42100,126210
2431,2013-03-08,3.0,24,69700,28,86700,-17000,14600,43350
2432,2013-03-07,2.9,31,136000,44,111800,24200,86800,257640
2433,2013-03-06,2.8,12,5700,27,166500,-160800,2000,5490
2434,2013-03-05,2.8,16,24200,19,47400,-23200,8400,22940
2435,2013-03-04,2.8,27,89500,50,143600,-54100,83700,234670
2436,2013-03-01,2.9,18,112300,39,105500,6800,53600,155440
2437,2013-02-28,2.9,22,73100,19,42500,30600,18100,51470
2438,2013-02-27,2.8,34,99200,25,86200,13000,48100,130870
2439,2013-02-26,2.8,35,86200,39,115100,-28900,38100,109300
2440,2013-02-25,2.9,53,146400,45,98800,47600,18000,52300
2441,2013-02-22,3.0,54,156900,29,116000,40900,69400,201720
2442,2013-02-21,2.9,55,112500,85,258800,-146300,112500,335880
2443,2013-02-20,3.2,50,195400,45,119900,75500,30800,95490
2444,2013-02-19,3.0,39,145500,55,176500,-31000,88600,274780
2445,2013-02-18,3.1,57,198100,46,208000,-9900,124700,379050
2446,2013-02-08,3.1,18,44100,47,134500,-90400,17400,55120
2447,2013-02-07,3.2,15,34400,44,122500,-88100,15000,46520
2448,2013-02-06,3.1,28,67500,46,120700,-53200,40400,124730
2449,2013-02-05,3.0,24,52600,29,45500,7100,5500,16380
2450,2013-02-04,3.0,30,88600,21,21800,66800,9400,28200
2451,2013-02-01,2.9,29,73400,52,120900,-47500,34200,101100
2452,2013-01-31,3.1,36,117400,50,126300,-8900,31100,93440
2453,2013-01-30,3.0,39,145200,71,199700,-54500,76500,236060
2454,2013-01-29,3.0,26,77400,77,345600,-268200,57700,178420
2455,2013-01-28,3.2,26,41800,76,274500,-232700,38000,121030
2456,2013-01-25,3.3,26,30900,60,211300,-180400,17000,53570
2457,2013-01-24,3.2,29,54200,38,119200,-65000,23500,71800
2458,2013-01-23,3.0,41,123100,65,129300,-6200,77200,227580
2459,2013-01-22,3.0,33,88800,64,184600,-95800,43600,130520
2460,2013-01-21,3.2,61,139000,70,165900,-26900,33600,105970
2461,2013-01-18,3.2,49,106500,66,154300,-47800,41600,132060
2462,2013-01-17,3.3,61,116200,86,233600,-117400,85300,345430
2463,2013-01-16,3.4,73,116000,71,254300,-138300,83400,291460
2464,2013-01-15,3.3,86,289600,57,158400,131200,158400,515230
2465,2013-01-14,3.0,40,41000,58,131300,-90300,41000,124420
2466,2013-01-11,3.2,33,196700,80,359200,-162500,116800,374300
2467,2013-01-10,3.3,57,130500,71,261100,-130600,126000,388190
2468,2013-01-09,3.1,104,474200,179,591900,-117700,421500,1417760
2469,2013-01-08,3.3,34,500900,20,47100,453800,47100,155430
2470,2013-01-07,3.1,48,829600,14,26500,803100,26500,82150
2471,2013-01-04,2.9,47,289500,32,79000,210500,79000,226970
2472,2013-01-03,2.8,103,284200,65,248600,35600,248600,696080
2473,2013-01-02,2.7,57,172300,22,68900,103400,68900,186030
2474,2012-12-28,2.6,56,227400,23,134700,92700,119100,300450
2475,2012-12-27,2.5,44,108300,39,172700,-64400,107700,271900
2476,2012-12-26,2.6,33,55200,40,82100,-26900,29000,74300
2477,2012-12-25,2.6,28,63600,47,148800,-85200,52000,130070
2478,2012-12-24,2.7,33,62800,40,99900,-37100,43800,111930
2479,2012-12-21,2.6,20,26900,23,28800,-1900,8800,21880
2480,2012-12-20,2.5,21,62900,47,141500,-78600,62200,156660
2481,2012-12-19,2.6,29,122200,25,54000,68200,54000,140300
2482,2012-12-18,2.5,29,87200,32,55100,32100,25400,63220
2483,2012-12-17,2.5,21,64700,53,122200,-57500,61300,153250
2484,2012-12-14,2.6,28,133100,51,144500,-11400,53600,139360
2485,2012-12-13,2.6,45,99600,41,135400,-35800,59900,156060
2486,2012-12-12,2.6,50,220600,36,140700,79900,140700,365270
2487,2012-12-11,2.5,78,265400,41,141900,123500,141900,354750
2488,2012-12-10,2.4,61,304300,19,180600,123700,180600,431250
2489,2012-12-07,2.4,22,45600,30,95400,-49800,12300,28310
2490,2012-12-06,2.3,22,56900,38,251200,-194300,22500,51760
2491,2012-12-05,2.4,12,34900,32,213700,-178800,34900,83780
2492,2012-12-04,2.5,22,113900,33,97600,16300,50700,121930
2493,2012-12-03,2.4,12,56900,14,51400,5500,1800,4170
2494,2012-11-30,2.3,17,73400,21,81600,-8200,12800,29430
2495,2012-11-29,2.3,19,74000,26,86800,-12800,38800,85630
2496,2012-11-28,2.3,27,70400,20,60800,9600,33300,76490
2497,2012-11-27,2.3,18,72500,39,141500,-69000,72500,167510
2498,2012-11-26,2.4,16,66100,35,118000,-51900,66100,158640
2499,2012-11-23,2.5,17,53100,34,125600,-72500,41600,104000
2500,2012-11-22,2.6,59,136400,37,152800,-16400,123900,381710
2501,2012-11-21,2.5,17,33300,46,151300,-118000,33300,83250
2502,2012-11-20,2.6,31,151700,31,234800,-83100,151700,394420
2503,2012-11-19,2.7,25,106300,68,215800,-109500,106300,287160
2504,2012-11-16,2.9,15,74000,34,89500,-15500,12200,33520
2505,2012-11-15,2.9,15,39500,37,98200,-58700,21700,59430
2506,2012-11-14,2.9,17,69700,32,121800,-52100,30200,84580
2507,2012-11-13,2.9,20,43600,30,95400,-51800,14000,38330
2508,2012-11-12,2.9,24,68100,24,50300,17800,8900,187100
2509,2012-11-09,2.8,17,48700,26,74800,-26100,21400,57890
2510,2012-11-08,2.8,7,25700,45,134300,-108600,11000,29710
2511,2012-11-07,2.9,15,35500,27,55800,-20300,8000,22520
2512,2012-11-06,2.8,18,51600,24,42100,9500,32400,86330
2513,2012-11-05,2.7,18,33500,37,76800,-43300,33500,90520
2514,2012-11-02,2.9,22,67900,52,146200,-78300,57800,161880
2515,2012-11-01,3.0,19,57900,30,61300,-3400,6200,17990
2516,2012-10-31,3.0,19,68400,39,68700,-300,28600,82570
2517,2012-10-30,3.0,27,94500,35,80800,13700,46100,132760
2518,2012-10-29,3.0,13,39500,31,73000,-33500,7700,23100
2519,2012-10-26,3.0,37,75000,25,74700,300,22600,66110
2520,2012-10-25,2.9,22,68100,43,156300,-88200,40100,116360
2521,2012-10-24,3.0,33,71500,46,103400,-31900,30200,89620
2522,2012-10-23,3.1,24,72100,15,30100,42000,100,310
2523,2012-10-22,2.9,25,52200,44,125400,-73200,33800,100090
2524,2012-10-19,3.0,75,200800,40,165300,35500,119800,360400
2525,2012-10-18,3.2,54,113400,36,131700,-18300,63400,197880
2526,2012-10-17,3.2,33,120500,59,286500,-166000,118500,369690
2527,2012-10-16,3.3,53,247500,41,156400,91100,81700,266160
2528,2012-10-15,3.2,28,43600,38,91100,-47500,29000,89920
2529,2012-10-12,3.2,36,69000,41,158400,-89400,50000,160110
2530,2012-10-11,3.3,62,245700,74,226300,19400,110900,370230
2531,2012-10-10,3.2,33,86300,52,117500,-31200,35400,112930
2532,2012-10-09,3.2,26,131500,52,111600,19900,21600,68830
2533,2012-10-08,3.2,49,94100,49,144900,-50800,54000,168720
2534,2012-10-05,3.1,31,148400,27,58700,89700,34300,105920
2535,2012-10-04,3.0,17,58300,27,86200,-27900,7500,22300
2536,2012-10-03,3.1,22,78600,22,38400,40200,4500,40550
2537,2012-10-02,3.0,39,121800,43,79300,42500,42200,126140
2538,2012-10-01,3.1,17,34400,44,102100,-67700,22000,93110
2539,2012-09-28,3.2,22,30100,44,125000,-94900,17600,54950
2540,2012-09-27,3.3,23,63700,47,117800,-54100,7300,23370
2541,2012-09-26,3.3,54,140400,54,195100,-54700,65100,208680
2542,2012-09-25,3.3,24,41400,39,149500,-108100,21600,67710
2543,2012-09-24,3.3,19,24700,41,75700,-51000,14300,46950
2544,2012-09-21,3.4,34,101200,37,104500,-3300,20700,68380
2545,2012-09-20,3.4,33,88800,54,156900,-68100,68000,218690
2546,2012-09-19,3.4,51,1296900,37,126900,1170000,88200,287420
2547,2012-09-18,3.3,19,423900,104,317600,106300,167800,569850
2548,2012-09-17,3.5,47,822500,77,162300,660200,71000,250290
2549,2012-09-14,3.4,44,626400,45,39300,587100,39300,132520
2550,2012-09-13,3.2,29,117100,22,42300,74800,13500,42420
2551,2012-09-12,3.1,42,189700,23,54600,135100,27900,86490
2552,2012-09-11,3.1,39,100900,37,114000,-13100,77700,237090
2553,2012-09-10,3.2,32,131400,55,187800,-56400,131400,422280
2554,2012-09-07,3.4,26,51400,34,78000,-26600,24200,82710
2555,2012-09-06,3.5,25,89800,41,89700,100,29600,100970
2556,2012-09-05,3.5,24,122500,64,161100,-38600,76200,266700
2557,2012-09-04,3.6,21,171200,50,115100,56100,18800,66990
2558,2012-08-31,3.6,28,170600,58,99900,70700,25900,91310
2559,2012-08-30,3.6,27,345200,81,216000,129200,127100,458070
2560,2012-08-29,3.6,55,265500,43,97500,168000,97500,349790
2561,2012-08-28,3.4,48,219800,33,84500,135300,49600,162360
2562,2012-08-27,3.3,29,55800,72,182100,-126300,55800,185450
2563,2012-08-24,3.5,109,378600,60,200500,178100,200500,668570
2564,2012-08-23,3.3,47,266600,77,356700,-90100,266600,884450
2565,2012-08-22,3.5,68,130600,59,213900,-83300,130600,458200
2566,2012-08-21,3.7,53,191200,79,352600,-161400,191200,709010
2567,2012-08-20,3.8,40,175900,69,252200,-76300,110700,431060
2568,2012-08-17,3.9,40,123100,76,279100,-156000,74300,289770
2569,2012-08-16,3.9,51,96500,33,134600,-38100,16600,63590
2570,2012-08-15,3.8,65,166900,59,258100,-91200,104700,397930
2571,2012-08-14,3.9,86,386200,60,284900,101300,215300,839730
2572,2012-08-13,3.9,59,154000,53,259600,-105600,86100,328380
2573,2012-08-10,4.0,36,51500,78,265100,-213600,41900,164358
2574,2012-08-09,4.0,61,150600,86,258400,-107800,76900,312680
2575,2012-08-08,4.1,46,108800,69,173000,-64200,26000,4360240
2576,2012-08-07,4.0,53,104100,88,189200,-85100,52100,206950
2577,2012-08-06,4.0,82,263000,65,185700,77300,185700,740680
2578,2012-08-03,3.8,36,115300,50,88400,26900,28900,109870
2579,2012-08-02,3.8,46,183100,54,127500,55600,34700,134130
2580,2012-08-01,3.9,58,302200,66,243200,59000,164700,622440
2581,2012-07-31,3.9,36,145300,60,189300,-44000,59800,603370
2582,2012-07-30,3.9,42,153500,58,127100,26400,35600,135160
2583,2012-07-27,3.9,39,182300,79,219400,-37100,122000,471320
2584,2012-07-26,3.9,71,268000,52,167400,100600,94700,364540
2585,2012-07-25,3.9,98,204200,39,159600,44600,43400,165060
2586,2012-07-24,3.8,86,149400,60,174000,-24600,77000,293600
2587,2012-07-23,3.9,65,121400,80,202500,-81100,72300,292820
2588,2012-07-20,4.2,98,258500,93,241600,16900,154000,642800
2589,2012-07-19,4.1,132,384500,96,270000,114500,270000,1104480
2590,2012-07-18,3.9,107,299300,95,304800,-5500,156000,623050
2591,2012-07-17,4.0,65,149100,62,126600,22500,58900,234710
2592,2012-07-16,3.9,59,145700,73,177000,-31300,107900,413850
2593,2012-07-13,3.9,117,303600,80,147600,156000,147600,570350
2594,2012-07-12,3.7,103,309700,74,220000,89700,159600,571820
2595,2012-07-11,3.6,50,132300,53,160300,-28000,44100,158900
2596,2012-07-10,3.6,66,168400,51,220200,-51800,83900,296380
2597,2012-07-09,3.7,29,132000,80,278100,-146100,132000,489180
2598,2012-07-06,3.8,86,123900,88,246900,-123000,99800,388570
2599,2012-07-05,3.9,71,202200,50,206800,-4600,168600,636700
2600,2012-07-04,3.7,52,76000,54,169400,-93400,43500,164260
2601,2012-07-03,3.8,42,289100,51,164600,124500,40800,153810
2602,2012-07-02,3.9,48,145000,57,220200,-75200,90800,354260
2603,2012-06-29,4.0,40,127800,80,173100,-45300,29200,118530
2604,2012-06-28,4.2,56,162900,50,163400,-500,111100,478570
2605,2012-06-27,4.0,67,223100,65,203700,19400,125400,500020
2606,2012-06-26,3.9,110,303000,71,355600,-52600,290800,1137900
2607,2012-06-25,4.1,90,158000,90,433100,-275100,100100,411650
2608,2012-06-22,4.4,70,190500,96,284800,-94300,117200,506710
2609,2012-06-21,4.4,67,221000,89,203200,17800,66700,293470
2610,2012-06-20,4.4,99,231400,65,170900,60500,48500,211220
2611,2012-06-19,4.3,91,260400,77,196700,63700,48900,213410
2612,2012-06-18,4.5,77,164100,128,387600,-223500,88200,397450
2613,2012-06-15,4.5,104,304400,87,268500,35900,96500,427460
2614,2012-06-14,4.3,94,421700,85,334500,87200,149300,653000
2615,2012-06-13,4.4,130,533800,78,311800,222000,103700,457850
2616,2012-06-12,4.5,99,398900,120,298900,100000,166400,738830
2617,2012-06-11,4.7,93,244900,110,354000,-109100,92500,425800
2618,2012-06-08,4.7,125,274400,209,531900,-257500,219300,1049450
2619,2012-06-07,4.8,191,844200,196,554600,289600,554600,2621060
2620,2012-06-06,4.5,110,260200,146,464900,-204700,115700,515510
2621,2012-06-05,4.5,124,308300,86,256700,51600,96200,417550
2622,2012-06-04,4.4,95,178500,91,315900,-137400,138500,587770
2623,2012-06-01,4.5,141,286600,119,444100,-157500,147300,660020
2624,2012-05-31,4.4,131,353700,103,249000,104700,143800,623470
2625,2012-05-30,4.5,113,445700,127,360100,85600,103400,466500
2626,2012-05-29,4.5,106,304400,137,417900,-113500,114800,516740
2627,2012-05-28,4.6,191,580600,154,451900,128700,417400,1948370
2628,2012-05-25,4.4,94,287100,23,56600,230500,56600,249020
2629,2012-05-24,4.4,178,390200,121,325400,64800,197300,827950
2630,2012-05-23,4.3,83,190300,173,448200,-257900,190300,828220
2631,2012-05-22,4.6,232,589000,128,412100,176900,412100,1889160
2632,2012-05-21,4.3,174,402900,48,132200,270700,132200,567100
2633,2012-05-18,4.0,193,606400,140,649800,-43400,505400,2054460
2634,2012-05-17,4.3,168,492200,118,487300,4900,321900,1423440
2635,2012-05-16,4.6,287,560200,152,514200,46000,384800,1711260
2636,2012-05-15,4.6,182,409200,129,626100,-216900,409200,1901260
2637,2012-05-14,4.9,167,412200,168,693200,-281000,412200,2058790
2638,2012-05-11,5.3,229,626000,232,936500,-310500,612200,3289140
2639,2012-05-10,5.6,253,715700,206,686900,28800,546300,2990340
2640,2012-05-09,5.4,226,465600,172,521300,-55700,332800,1776860
2641,2012-05-08,5.4,293,628600,266,1040900,-412300,596100,3348240
2642,2012-05-07,5.6,238,783800,148,489600,294200,489600,2718640
2643,2012-05-04,5.3,204,907200,250,824400,82800,761200,3948230
2644,2012-05-03,4.9,120,407400,182,611100,-203700,266800,1323780
2645,2012-05-02,5.0,263,1014800,251,945400,69400,875000,4432370
2646,2012-04-27,4.8,246,695300,147,559000,136300,428600,2053633
2647,2012-04-26,4.6,114,306500,177,623200,-316700,213500,995040
2648,2012-04-25,4.7,203,642800,124,427500,215300,269400,1285920
2649,2012-04-24,4.6,156,417900,146,544000,-126100,221200,1009430
2650,2012-04-23,4.8,146,388700,148,377500,11200,175500,834360
2651,2012-04-20,4.8,155,412700,129,379300,33400,143300,683100
2652,2012-04-19,4.7,190,543900,180,559700,-15800,297400,1420460
2653,2012-04-18,4.8,247,696500,217,755600,-59100,486000,2342820
2654,2012-04-17,4.8,223,569900,200,871700,-301800,439600,2122850
2655,2012-04-16,5.0,139,611500,193,503400,108100,400700,2009390
2656,2012-04-13,4.8,131,470200,277,823200,-353000,240600,1176070
2657,2012-04-12,5.0,283,964900,233,735200,229700,735200,3643390
2658,2012-04-11,4.7,244,777900,155,410500,367400,410500,1907240
2659,2012-04-10,4.4,139,221200,217,571500,-350300,119900,540760
2660,2012-04-09,4.7,150,572200,173,397600,174600,214500,977371
2661,2012-04-06,4.4,119,348100,154,396700,-48600,118200,524890
2662,2012-04-05,4.4,173,628200,85,190700,437500,190700,820770
2663,2012-04-04,4.2,153,363100,128,589100,-226000,287400,1240910
2664,2012-04-03,4.4,201,595400,120,243300,352100,243300,1044020
2665,2012-03-30,4.2,153,423600,146,767300,-343700,423600,1781590
2666,2012-03-29,4.5,147,373100,205,833800,-460700,373100,1689170
2667,2012-03-28,4.8,187,622500,206,707300,-84800,571900,2634070
2668,2012-03-27,4.8,156,382800,267,830900,-448100,382800,1927800
2669,2012-03-26,5.1,203,583700,163,470300,113400,470300,2378090
2670,2012-03-23,4.9,284,1126400,193,829900,296500,799800,3869420
2671,2012-03-22,4.5,177,731200,235,888900,-157700,379500,1728330
2672,2012-03-21,4.6,343,1126300,244,956200,170100,908100,4195160
2673,2012-03-20,4.5,198,842200,174,851600,-9400,445700,1952870
2674,2012-03-19,4.2,129,341400,134,284700,56700,141200,601540
2675,2012-03-16,4.2,226,646500,86,414900,231600,414900,1742580
2676,2012-03-15,4.2,222,800500,150,695700,104800,625200,2499140
2677,2012-03-14,3.9,120,214300,88,401900,-187600,126300,501820
2678,2012-03-13,4.1,190,337000,103,391900,-54900,232600,927000
2679,2012-03-12,4.0,68,323800,156,533100,-209300,323800,1295620
2680,2012-03-09,4.2,145,378100,154,489500,-111400,344100,1441850
2681,2012-03-08,4.3,165,487000,219,594300,-107300,417600,1820700
2682,2012-03-07,4.6,196,558000,209,489700,68300,403500,1807890
2683,2012-03-06,4.6,519,2055500,329,1860200,195300,1701100,7858510
2684,2012-03-05,4.4,117,563800,21,130000,433800,130000,572000
2685,2012-03-02,4.2,127,535200,70,273700,261500,273700,1148240
2686,2012-03-01,4.0,118,490800,74,228300,262500,228300,907940
2687,2012-02-29,4.0,130,530200,150,399900,130300,315400,1210820
2688,2012-02-28,3.7,211,600600,110,583600,17000,503100,1942910
2689,2012-02-27,3.8,199,665200,117,389500,275700,389500,1445760
2690,2012-02-24,3.6,180,477900,102,470000,7900,322200,1170650
2691,2012-02-23,3.5,116,374500,71,221300,153200,221300,774550
2692,2012-02-22,3.4,105,720800,127,374100,346700,374100,1244150
2693,2012-02-21,3.1,179,530700,111,536600,-5900,391500,1241750
2694,2012-02-20,3.1,65,171100,15,63600,107500,63600,196350
2695,2012-02-17,2.9,80,222400,8,69700,152700,69700,202130
2696,2012-02-16,2.9,74,231700,43,237400,-5700,103100,290220
2697,2012-02-15,2.9,78,183900,66,225700,-41800,100700,296590
2698,2012-02-14,3.0,108,255200,73,327200,-72000,187500,554490
2699,2012-02-13,3.0,22,62500,60,275700,-213200,62500,187500
2700,2012-02-10,3.2,48,136700,108,317500,-180800,136700,437960
2701,2012-02-09,3.4,143,407100,74,288100,119000,285200,963590
2702,2012-02-08,3.2,74,175100,22,81800,93300,81800,261760
2703,2012-02-07,3.1,90,225600,52,102600,123000,102600,310930
2704,2012-02-06,3.0,75,240900,86,246700,-5800,205600,602740
2705,2012-02-03,3.1,116,433400,79,343000,90400,343000,1062200
2706,2012-02-02,2.9,45,169200,16,40500,128700,40500,144450
2707,2012-02-01,2.9,51,188300,53,136300,52000,106200,299830
2708,2012-01-31,2.8,91,409700,47,280400,129300,280400,785120
2709,2012-01-30,2.7,29,109400,12,29700,79700,29700,80190
2710,2012-01-20,2.6,65,231400,42,144400,87000,144400,375440
2711,2012-01-19,2.5,41,141000,25,78700,62300,78700,196750
2712,2012-01-18,2.5,29,84400,21,56100,28300,23500,56410
2713,2012-01-17,2.4,40,60300,23,52100,8200,14600,35090
2714,2012-01-16,2.4,35,76400,30,112000,-35600,47100,113080
2715,2012-01-13,2.4,33,47100,25,80500,-33400,29200,68900
2716,2012-01-12,2.4,22,36800,32,171700,-134900,36800,88370
2717,2012-01-11,2.4,27,48900,38,83700,-34800,43500,106780
2718,2012-01-10,2.5,51,75500,18,36100,39400,36100,90250
2719,2012-01-09,2.5,40,84100,44,111400,-27300,78800,191940
2720,2012-01-06,2.5,21,36800,34,101200,-64400,36800,93070
2721,2012-01-05,2.6,21,30900,16,46800,-15900,19300,50120
2722,2012-01-04,2.5,23,46100,21,47600,-1500,40800,102010
2723,2012-01-03,2.6,23,39900,23,35800,4100,31100,81270
2724,2011-12-30,2.6,45,46400,32,12600,33800,12600,32390
2725,2011-12-29,2.5,27,30100,31,79000,-48900,30100,75460
2726,2011-12-28,2.7,39,88600,35,88200,400,58900,155140
2727,2011-12-27,2.6,19,23600,41,65600,-42000,23600,61380
2728,2011-12-26,2.6,27,29800,24,27300,2500,22200,59060
2729,2011-12-23,2.6,29,25400,21,27500,-2100,17500,45690
2730,2011-12-22,2.8,37,47300,33,71400,-24100,46600,126140
2731,2011-12-21,2.9,36,57900,37,84400,-26500,16600,48140
2732,2011-12-20,2.9,44,59200,34,120900,-61700,59200,171780
2733,2011-12-19,3.0,31,81100,35,122000,-40900,70100,217690
2734,2011-12-16,3.2,65,163900,31,120000,43900,74300,239390
2735,2011-12-15,3.1,53,135300,38,159600,-24300,132800,411690
2736,2011-12-14,3.4,37,57800,45,73100,-15300,40500,134600
2737,2011-12-13,3.5,32,46000,40,86100,-40100,38200,134120
2738,2011-12-12,3.6,27,61600,37,83700,-22100,20700,74550
2739,2011-12-09,3.7,30,43600,42,66700,-23100,34800,129260
2740,2011-12-08,3.8,45,103700,28,63600,40100,29900,112630
2741,2011-12-07,3.8,46,98500,62,175800,-77300,98500,374830
2742,2011-12-06,3.9,53,88500,57,101700,-13200,69100,275250
2743,2011-12-05,3.9,69,149200,25,82100,67100,82100,319690
2744,2011-12-02,3.7,44,96600,38,94200,2400,67600,250740
2745,2011-12-01,3.7,41,73800,23,43700,30100,26500,97010
2746,2011-11-30,3.7,32,44100,39,86400,-42300,43800,163280
2747,2011-11-29,3.9,18,20300,21,22700,-2400,2400,9260
2748,2011-11-28,3.9,39,127700,31,47200,80500,46300,178650
2749,2011-11-25,3.8,29,37500,32,70100,-32600,15600,58300
2750,2011-11-24,3.8,25,27500,28,76300,-48800,19500,75290
2751,2011-11-23,3.9,30,33100,19,31300,1800,14600,56950
2752,2011-11-22,3.8,36,53900,21,45900,8000,19600,73840
2753,2011-11-21,3.8,14,32300,20,44500,-12200,18100,69010
2754,2011-11-18,3.8,22,40900,26,32800,8100,13400,52080
2755,2011-11-17,3.9,31,54900,17,32800,22100,19300,76710
2756,2011-11-16,4.1,43,132100,31,60800,71300,60800,244810
2757,2011-11-15,4.0,56,79700,44,81700,-2000,42300,164610
2758,2011-11-14,3.8,37,72000,31,78900,-6900,38300,148330
2759,2011-11-11,4.0,44,68300,39,88200,-19900,47600,190790
2760,2011-11-10,4.0,53,98100,48,137800,-39700,86000,345410
2761,2011-11-09,4.2,48,112600,34,74400,38200,36800,154470
2762,2011-11-08,4.2,72,114200,44,97300,16900,47500,199580
2763,2011-11-07,4.2,54,109800,31,84100,25700,43000,180110
2764,2011-11-04,4.3,56,91200,46,117800,-26600,53300,230240
2765,2011-11-03,4.4,59,100600,34,85200,15400,49000,215150
2766,2011-11-02,4.4,57,101100,47,88200,12900,46000,202540
2767,2011-11-01,4.5,57,82300,64,174100,-91800,79400,359220
2768,2011-10-31,4.8,82,170000,79,204900,-34900,140000,678750
2769,2011-10-28,4.8,68,139500,50,79300,60200,79300,378550
2770,2011-10-27,4.4,47,79300,31,108800,-29500,30100,134720
2771,2011-10-26,4.6,47,90000,38,85700,4300,50200,227230
2772,2011-10-25,4.6,27,41200,39,96600,-55400,26400,120360
2773,2011-10-24,4.6,58,69800,54,105200,-35400,43500,209240
2774,2011-10-21,4.8,109,280800,55,150700,130100,150700,706100
2775,2011-10-20,4.4,48,57100,46,64600,-7500,35900,160100
2776,2011-10-19,4.5,49,53800,35,60200,-6400,15300,68580
2777,2011-10-18,4.4,52,76900,30,80500,-3600,47800,208960
2778,2011-10-17,4.4,43,70000,45,58800,11200,36000,162230
2779,2011-10-14,4.5,92,200100,57,129600,70500,100400,452510
2780,2011-10-13,4.5,92,162100,59,159000,3100,102400,459360
2781,2011-10-12,4.6,77,129400,72,191400,-62000,129200,597700
2782,2011-10-11,4.9,65,123400,49,98600,24800,49000,238700
2783,2011-10-10,4.8,44,67900,73,122600,-54700,57600,282000
2784,2011-10-07,5.0,76,151700,82,181400,-29700,100600,508990
2785,2011-10-06,5.2,74,168000,54,125400,42600,94800,483670
2786,2011-10-05,4.8,63,104600,51,83000,21600,48700,236390
2787,2011-10-04,4.8,84,155500,47,96500,59000,82300,383330
2788,2011-10-03,4.8,79,169500,74,262700,-93200,157400,744560
2789,2011-09-30,4.9,69,117400,53,110700,6700,73300,364660
2790,2011-09-29,5.1,96,170300,88,217900,-47600,118700,601460
2791,2011-09-28,5.3,98,138200,87,174000,-35800,76200,406550
2792,2011-09-27,5.2,87,155600,87,209500,-53900,94000,496800
2793,2011-09-26,5.2,62,120300,75,208800,-88500,76300,402040
2794,2011-09-23,5.4,105,164600,82,208700,-44100,85900,465150
2795,2011-09-22,5.5,120,245000,78,186900,58100,131700,711140
2796,2011-09-21,5.4,109,221900,94,186800,35100,110500,589980
2797,2011-09-20,5.3,139,295700,106,361400,-65700,272700,1438680
2798,2011-09-19,5.6,133,309500,104,279100,30400,174000,949020
2799,2011-09-16,5.5,95,201800,141,431000,-229200,201800,1125600
2800,2011-09-15,5.9,104,313400,145,527900,-214500,313400,1856260
2801,2011-09-14,5.9,193,481900,213,521200,-39300,419900,2625560
2802,2011-09-13,6.0,132,491300,88,363900,127400,363900,2176550
2803,2011-09-12,5.8,167,452500,121,284400,168100,284400,1621090
2804,2011-09-09,5.5,99,221200,127,327100,-105900,144000,785370
2805,2011-09-08,5.5,112,338800,128,382400,-43600,301400,1702040
2806,2011-09-07,5.6,123,285400,91,300500,-15100,232100,1268100
2807,2011-09-06,5.3,39,105500,102,263300,-157800,105500,560310
2808,2011-09-05,5.4,96,326200,123,380800,-54600,262100,1458080
2809,2011-09-01,5.4,159,647600,114,293200,354400,293200,1568760
2810,2011-08-31,5.1,87,196500,128,338600,-142100,140000,708340
2811,2011-08-30,5.0,132,244400,74,316500,-72100,194500,982900
2812,2011-08-29,4.9,99,314800,61,185700,129100,185700,892350
2813,2011-08-26,4.6,42,96400,72,123900,-27500,65900,302640
2814,2011-08-25,4.7,77,121400,86,119500,1900,74100,339200
2815,2011-08-24,4.5,59,90900,71,155700,-64800,58500,268010
2816,2011-08-23,4.5,65,166700,93,254400,-87700,110000,504250
2817,2011-08-22,4.6,105,152700,44,95400,57300,95400,438320
2818,2011-08-19,4.3,50,94900,101,184900,-90000,82200,352590
2819,2011-08-18,4.5,69,153300,80,163900,-10600,115500,518510
2820,2011-08-17,4.3,84,155200,52,79800,75400,79800,339800
2821,2011-08-16,4.1,48,71600,48,61600,10000,23200,95160
2822,2011-08-15,4.0,39,65400,40,48900,16500,23700,96730
2823,2011-08-12,4.0,41,51900,32,45200,6700,16600,90720
2824,2011-08-11,4.0,41,102300,43,102000,300,64200,257480
2825,2011-08-10,4.1,71,110600,50,61900,48700,51900,212330
2826,2011-08-09,3.9,66,86900,47,123400,-36500,85600,334280
2827,2011-08-08,4.1,35,50500,50,86400,-35900,21700,89010
2828,2011-08-05,4.3,90,223200,40,91900,131300,91900,394320
2829,2011-08-04,4.1,76,255100,22,39600,215500,39600,162240
2830,2011-08-03,4.0,60,127500,33,48400,79100,31100,121940
2831,2011-08-02,4.0,78,153600,52,180700,-27100,148700,597030
2832,2011-08-01,4.1,79,85900,39,72800,13100,42600,178580
2833,2011-07-29,4.4,88,177200,43,207200,-30000,176700,5799520
2834,2011-07-28,4.7,69,84400,50,79100,5300,46900,218160
2835,2011-07-27,4.6,50,70900,35,90300,-19400,50200,236820
2836,2011-07-26,5.0,32,66600,27,47300,19300,21300,104970
2837,2011-07-25,4.9,23,37900,35,50300,-12400,15700,76770
2838,2011-07-22,4.9,23,54300,26,40400,13900,8000,40190
2839,2011-07-21,4.9,28,59200,40,68700,-9500,13200,65270
2840,2011-07-20,5.2,39,103200,36,46800,56400,21100,106580
2841,2011-07-19,4.9,33,85400,34,75600,9800,37500,186160
2842,2011-07-18,5.0,35,67400,26,55200,12200,25100,125500
2843,2011-07-15,5.0,42,75100,24,62600,12500,24200,120300
2844,2011-07-14,5.0,71,122000,36,82300,39700,40200,198020
2845,2011-07-13,5.0,35,63100,28,70500,-7400,19300,97010
2846,2011-07-12,5.1,68,213900,32,63600,150300,59000,295780
2847,2011-07-11,5.0,62,116400,34,113700,2700,74800,668680
2848,2011-07-08,5.3,44,54100,35,48400,5700,9900,51280
2849,2011-07-07,5.4,50,72800,27,56100,16700,13000,68530
2850,2011-07-06,5.3,39,75700,44,88300,-12600,28700,152360
2851,2011-07-05,5.4,46,79500,19,43700,35800,43700,235970
2852,2011-07-04,5.2,64,116200,35,57600,58600,32700,166860
2853,2011-07-01,5.1,81,187500,55,192200,-4700,158000,812880
2854,2011-06-30,5.3,60,94400,44,70000,24400,38900,211210
2855,2011-06-29,5.6,56,83700,45,60800,22900,30000,166000
2856,2011-06-28,5.6,68,104600,54,117600,-13000,67200,374070
2857,2011-06-27,5.8,75,112300,56,114200,-1900,45200,263080
2858,2011-06-24,5.8,79,182600,85,120100,62500,34900,204020
2859,2011-06-23,5.8,59,109200,78,102600,6600,38300,224610
2860,2011-06-22,6.0,65,129900,75,163800,-33900,67000,411510
2861,2011-06-21,6.2,119,219800,78,133100,86700,116600,706740
2862,2011-06-20,5.7,81,320900,94,377700,-56800,287600,1657490
2863,2011-06-17,6.1,80,243900,100,343400,-99500,243900,1491990
2864,2011-06-16,6.6,110,226300,116,221600,4700,144100,935940
2865,2011-06-15,6.4,75,121800,146,276000,-154200,121800,785200
2866,2011-06-14,6.7,236,786700,161,723700,63000,685600,4632990
2867,2011-06-13,6.4,169,827000,70,331500,495500,331500,2119260
2868,2011-06-10,6.0,79,414800,17,47900,366900,47900,287400
2869,2011-06-09,5.8,134,547000,79,163900,383100,163900,933980
2870,2011-06-08,5.5,112,552700,100,256300,296400,177400,979780
2871,2011-06-07,5.4,86,417600,49,129800,287800,129800,700070
2872,2011-06-06,5.2,53,157300,80,127800,29500,78200,402210
2873,2011-06-03,5.2,106,224400,97,232200,-7800,191300,1009310
2874,2011-06-02,5.1,69,157400,30,75400,82000,75400,384410
2875,2011-06-01,4.9,49,152700,37,70200,82500,70200,338170
2876,2011-05-31,4.7,72,138700,63,140300,-1600,84500,386640
2877,2011-05-30,4.7,55,136800,74,149000,-12200,65200,310610
2878,2011-05-27,5.0,73,245500,45,81500,164000,81500,401620
2879,2011-05-26,4.9,109,211800,84,245300,-33500,179300,850210
2880,2011-05-25,4.9,36,117300,56,211600,-94300,117300,575180
2881,2011-05-24,5.2,29,98000,62,188100,-90100,98000,510620
2882,2011-05-23,5.4,59,114700,68,185300,-70600,108000,588840
2883,2011-05-20,5.6,59,86800,55,128900,-42100,54200,307080
2884,2011-05-19,5.9,67,105200,62,121400,-16200,62400,361990
2885,2011-05-18,6.0,58,115300,58,90700,24600,46000,272810
2886,2011-05-17,6.0,71,124600,71,167200,-42600,83600,503230
2887,2011-05-16,6.3,56,138200,75,128800,9400,63300,401230
2888,2011-05-13,6.4,55,76000,53,115200,-39200,32600,210130
2889,2011-05-12,6.5,41,92300,53,110500,-18200,34000,218600
2890,2011-05-11,6.5,81,128000,84,187200,-59200,63200,409310
2891,2011-05-10,6.5,62,113000,91,154400,-41400,44900,297740
2892,2011-05-09,6.6,87,177100,89,138100,39000,96800,639420
2893,2011-05-06,6.5,68,162500,65,115500,47000,72300,460960
2894,2011-05-05,6.2,81,91000,82,173800,-82800,55200,345940
2895,2011-05-04,6.4,85,178400,75,125800,52600,84200,552700
2896,2011-04-29,6.4,92,132300,76,146200,-13900,63600,405370
2897,2011-04-28,6.5,82,113100,69,161500,-48400,45100,293020
2898,2011-04-27,6.5,53,209700,57,138700,71000,66500,437370
2899,2011-04-26,6.6,88,133500,92,208000,-74500,98700,658590
2900,2011-04-25,7.0,92,205000,71,144800,60200,144800,1005430
2901,2011-04-22,6.9,153,257100,80,255800,1300,232600,1530170
2902,2011-04-21,6.9,104,149400,66,222500,-73100,116200,802650
2903,2011-04-20,7.2,100,176800,71,181500,-4700,104800,762220
2904,2011-04-19,7.5,109,125800,61,121200,4600,63300,478270
2905,2011-04-18,7.6,69,148600,68,157500,-8900,121400,926120
2906,2011-04-15,8.1,108,158600,76,167700,-9100,114900,927540
2907,2011-04-14,8.4,79,116800,58,132300,-15500,57300,481310
2908,2011-04-13,8.5,63,74100,40,114600,-40500,20700,175320
2909,2011-04-08,8.6,92,114200,51,160200,-46000,59800,514670
2910,2011-04-07,8.8,63,91700,85,188700,-97000,63000,558330
2911,2011-04-06,9.0,71,109000,66,111200,-2200,56900,506510
2912,2011-04-05,9.0,71,209200,46,111000,98200,53200,463720
2913,2011-04-04,8.8,55,87400,55,96500,-9100,47300,418400
2914,2011-04-01,8.9,56,76300,46,109600,-33300,22000,196040
2915,2011-03-31,9.0,80,189500,70,200500,-11000,116800,1051310
2916,2011-03-30,9.1,102,378800,61,163900,214900,127600,1147000
2917,2011-03-29,9.3,68,144000,88,206000,-62000,76400,711520
2918,2011-03-28,9.4,79,211200,109,281700,-70500,127500,1201320
2919,2011-03-25,9.3,85,172400,96,223200,-50800,104600,975500
2920,2011-03-24,9.4,105,222000,98,242800,-20800,123800,1169150
2921,2011-03-23,9.4,81,136600,72,105000,31600,47100,441360
2922,2011-03-22,9.4,122,315600,159,393700,-78100,279700,2633500
2923,2011-03-21,9.6,105,200300,157,290900,-90600,150700,1501720
2924,2011-03-18,9.8,192,438700,169,341000,97700,341000,3301820
2925,2011-03-17,9.3,80,287100,126,207400,79700,97700,902890
2926,2011-03-16,9.2,86,412300,96,219500,192800,108900,990860
2927,2011-03-15,8.9,69,194800,116,256600,-61800,111900,1014340
2928,2011-03-14,8.9,111,243400,143,385300,-141900,232400,2178280
2929,2011-03-11,9.5,78,253600,31,106600,147000,106600,1012000
2930,2011-03-10,9.0,63,217100,38,78000,139100,78000,694700
2931,2011-03-09,8.6,70,278400,71,206800,71600,125800,1064100
2932,2011-03-08,8.9,38,241500,54,113800,127700,38100,341150
2933,2011-03-07,9.0,64,182200,71,181600,600,128700,1164390
2934,2011-03-04,9.1,93,234000,94,271200,-37200,123500,1122130
2935,2011-03-03,9.0,126,333600,111,324000,9600,217500,1965400
2936,2011-03-02,9.4,138,243700,101,227800,15900,170100,1604650
2937,2011-03-01,9.7,94,153200,106,285200,-132000,99800,979730
2938,2011-02-28,9.9,110,408800,127,176600,232200,90700,911440
2939,2011-02-25,10.0,141,416000,100,195400,220600,195400,1921650
2940,2011-02-24,9.6,117,242000,90,118500,123500,64500,608450
2941,2011-02-23,9.8,127,186900,73,82300,104600,66500,640630
2942,2011-02-22,9.3,140,261500,64,110700,150800,88900,828620
2943,2011-02-21,9.6,142,280800,143,336100,-55300,280800,2704730
2944,2011-02-18,10.3,97,253500,73,156000,97500,89000,917690
2945,2011-02-17,10.5,102,192800,96,187700,5100,91600,966640
2946,2011-02-16,10.8,38,92500,91,168600,-76100,41900,456990
2947,2011-02-15,11.1,66,210400,115,210300,100,92400,1017960
2948,2011-02-14,11.0,55,145600,83,124400,21200,69500,768240
2949,2011-02-11,11.0,79,118300,80,198500,-80200,73600,807500
2950,2011-02-10,11.1,85,242600,118,273000,-30400,147000,1655760
2951,2011-02-09,11.2,58,113300,120,199400,-86100,73900,842610
2952,2011-02-08,11.4,53,69300,78,121100,-51800,28600,326650
2953,2011-01-28,11.1,136,359400,203,534400,-175000,307000,3461630
2954,2011-01-27,11.1,92,253900,113,179400,74500,118700,1300860
2955,2011-01-26,10.7,81,225400,67,70700,154700,38200,404570
2956,2011-01-25,10.3,109,229400,69,160200,69200,104700,1079620
2957,2011-01-24,10.4,68,186800,112,253400,-66600,161400,1692760
2958,2011-01-21,10.6,95,141700,121,225600,-83900,66500,713800
2959,2011-01-20,10.7,90,168000,117,247100,-79100,55000,596080
2960,2011-01-19,11.0,97,191000,121,245000,-54000,50200,546910
2961,2011-01-18,10.9,89,173300,186,364900,-191600,123800,1379580
2962,2011-01-17,11.3,98,237100,162,298200,-61100,138700,1576120
2963,2011-01-14,11.0,105,215500,113,269600,-54100,151000,1647800
2964,2011-01-13,10.9,84,208300,130,193800,14500,96000,1046290
2965,2011-01-12,10.6,138,244400,91,154900,89500,96400,1027610
2966,2011-01-11,10.4,129,166500,92,161600,4900,101100,1059230
2967,2011-01-10,10.8,139,256800,112,231100,25700,146400,1589400
2968,2011-01-07,11.2,125,214900,100,278200,-63300,130000,1466070
2969,2011-01-06,11.5,157,269100,102,329500,-60400,135900,1543020
2970,2011-01-05,11.5,125,152500,135,270000,-117500,102200,1179060
2971,2011-01-04,11.7,79,142900,147,245300,-102400,66600,790160
2972,2010-12-31,11.8,150,235200,131,271900,-36700,128300,1495240
2973,2010-12-30,11.6,163,291800,142,370200,-78400,174500,2024880
2974,2010-12-29,11.6,170,267400,234,419400,-152000,177800,2109900
2975,2010-12-28,12.2,226,461100,185,294100,167000,223300,2689820
2976,2010-12-27,11.6,174,544400,106,339000,205400,176200,2033230
2977,2010-12-24,11.4,285,406800,142,363600,43200,216100,2472330
2978,2010-12-23,11.4,286,463100,176,486100,-23000,339100,3890490
2979,2010-12-22,11.9,274,354600,155,519300,-164700,237100,2851910
2980,2010-12-21,12.3,252,355800,196,428600,-72800,184600,2269670
2981,2010-12-20,12.5,233,380000,213,381800,-1800,164700,2076730
2982,2010-12-17,12.7,309,488600,171,255800,232800,255800,3224520
2983,2010-12-16,11.8,347,519700,196,656700,-137000,519500,6196380
2984,2010-12-15,12.4,325,542500,259,691100,-148600,361000,4559800
2985,2010-12-14,13.0,299,507900,437,1051500,-543600,507900,6667220
2986,2010-12-13,13.9,153,423800,74,355800,68000,355800,4945620
2987,2010-12-10,13.1,265,763200,150,499400,263800,499400,6501680
2988,2010-12-09,12.5,353,702300,281,950400,-248100,654400,8051310
2989,2010-12-08,12.7,208,372100,285,614000,-241900,372100,4763890
2990,2010-12-07,13.3,252,449800,348,762300,-312500,449800,6115090
2991,2010-12-06,13.8,348,692100,307,709100,-17000,632000,9002590
2992,2010-12-03,13.6,309,1395700,174,653200,742500,653200,8881450
2993,2010-12-02,13.2,485,1220500,506,1341900,-121400,1024300,13147100
2994,2010-12-01,12.3,325,598800,409,1007200,-408400,543400,6984760
2995,2010-11-30,12.9,237,902000,122,417200,484800,417200,5377940
2996,2010-11-29,12.3,307,1208400,310,581800,626600,581800,7022290
2997,2010-11-26,11.5,339,1029200,346,809800,219400,809800,9298020
2998,2010-11-25,10.9,225,888000,226,392300,495700,392300,4237470
2999,2010-11-24,10.0,208,577500,277,539500,38000,369800,3781340
3000,2010-11-23,10.0,215,387400,175,304700,82700,214500,2130260
3001,2010-11-22,9.7,149,175500,142,251300,-75800,145300,1395490
3002,2010-11-19,10.1,254,627300,347,606100,21200,377100,3830100
3003,2010-11-18,10.1,140,591200,78,154800,436400,154800,1550060
3004,2010-11-17,9.6,220,365300,149,278300,87000,195500,1862090
3005,2010-11-16,9.4,158,450300,172,392800,57500,273100,2526440
3006,2010-11-15,9.5,174,280900,156,334300,-53400,214100,2100460
3007,2010-11-12,10.2,251,400200,189,496100,-95900,390600,3999590
3008,2010-11-11,10.8,236,379500,179,479400,-99900,359300,3928330
3009,2010-11-10,11.5,136,229800,120,314400,-84600,101500,1179020
3010,2010-11-09,11.7,182,315500,189,388800,-73300,247300,2918490
3011,2010-11-08,12.3,154,333500,170,328200,5300,208100,2578150
3012,2010-11-05,12.9,174,336400,199,337600,-1200,201700,2608560
3013,2010-11-04,12.4,191,309600,138,298000,11600,230000,2877800
3014,2010-11-03,12.5,163,215800,124,217600,-1800,154300,1941950
3015,2010-11-02,13.0,220,240300,163,212000,28300,113800,1469600
3016,2010-11-01,13.2,191,248900,153,315200,-66300,169500,2263070
3017,2010-10-29,13.7,202,263000,167,280300,-17300,133500,1815720
3018,2010-10-28,13.3,255,310300,144,364400,-54100,246900,3366390
3019,2010-10-27,13.8,218,293500,277,491200,-197700,244200,3450800
3020,2010-10-26,14.6,278,462000,166,371200,90800,371200,5401160
3021,2010-10-25,13.8,189,361500,184,364000,-2500,255000,3487650
3022,2010-10-22,13.4,191,406700,176,373700,33000,249700,3352240
3023,2010-10-21,13.7,245,407400,193,372100,35300,261900,3579610
3024,2010-10-20,13.7,354,546300,240,600500,-54200,530600,7209960
3025,2010-10-19,14.4,248,426600,221,419500,7100,295300,4289820
3026,2010-10-18,14.9,206,428000,256,405800,22200,267400,4036630
3027,2010-10-15,14.7,222,296100,176,349000,-52900,191500,2842920
3028,2010-10-14,15.0,318,1142700,287,587300,555400,383500,5830970
3029,2010-10-13,14.9,364,610400,218,436400,174000,341500,5009900
3030,2010-10-12,14.6,293,540600,165,340200,200400,229400,3367130
3031,2010-10-11,15.1,211,477600,167,310100,167500,197200,2967750
3032,2010-10-08,15.3,252,645800,305,694100,-48300,385600,5975090
3033,2010-10-07,15.7,513,1293100,371,1170800,122300,1055900,17144390
3034,2010-10-06,15.6,290,1484500,146,350600,1133900,350600,5362980
3035,2010-10-05,15.0,470,746800,250,651700,95100,541300,7906360
3036,2010-10-04,15.0,295,526900,212,769800,-242900,526900,7922320
3037,2010-10-01,15.8,358,833500,219,701400,132100,478600,7725460
3038,2010-09-30,16.7,420,882700,255,924200,-41500,686600,11320870
3039,2010-09-29,17.3,317,558100,262,926800,-368700,558100,9767080
3040,2010-09-28,18.1,350,1067100,313,890800,176300,542600,10013250
3041,2010-09-27,18.0,456,1256900,307,970300,286600,736100,13286590
3042,2010-09-24,18.2,356,824000,426,1299000,-475000,824000,15183800
3043,2010-09-23,19.4,747,2119000,535,1628700,490300,1346300,26199780
3044,2010-09-22,18.6,603,3683200,388,1432300,2250900,1432300,26544840
3045,2010-09-21,17.4,301,2652300,212,909000,1743300,909000,15813150
3046,2010-09-20,16.3,113,996200,36,95700,900500,95700,1559910
3047,2010-09-17,15.6,192,1231700,127,375300,856400,375300,5725350
3048,2010-09-16,14.7,100,132300,60,119200,13100,79300,1156470
3049,2010-09-15,14.4,70,98000,64,127800,-29800,74700,1090890
3050,2010-09-14,14.9,124,142700,95,138500,4200,96600,1439320
3051,2010-09-13,15.2,270,460900,280,581800,-120900,273500,4228780
3052,2010-09-01,17.0,121,321900,136,263800,58100,215800,3544110
3053,2010-08-31,15.9,118,286900,101,229100,57800,147800,2339950
3054,2010-08-30,15.1,80,196900,35,60000,136900,60000,900260
3055,2010-08-27,14.2,75,160200,46,104500,55700,83900,1160180
3056,2010-08-26,13.5,100,182800,60,91400,91400,74500,994630
3057,2010-08-25,12.6,93,141100,54,128000,13100,96500,1221360
3058,2010-08-24,13.5,56,100400,36,89500,10900,48400,653890
3059,2010-08-23,14.5,37,48100,45,78600,-30500,22700,325320
3060,2010-08-20,14.7,81,137000,63,126600,10400,68400,1007540
3061,2010-08-19,15.1,49,50700,35,68100,-17400,30700,463300
3062,2010-08-18,15.5,44,73600,41,98200,-24600,36800,564390
3063,2010-08-17,15.5,51,91200,94,233900,-142700,27800,442450
3064,2010-08-16,16.6,69,119900,41,58700,61200,56200,924310
3065,2010-08-13,15.5,89,137000,55,88500,48500,57400,868530
3066,2010-08-12,14.3,72,128400,61,166400,-38000,118900,1734370
3067,2010-08-11,16.1,80,109900,56,136300,-26400,43900,695320
3068,2010-08-10,15.4,76,104200,47,146700,-42500,76500,1192200
3069,2010-08-09,16.5,59,68200,52,148800,-80600,31300,515660
3070,2010-08-06,17.0,65,162100,113,293700,-131600,125500,2139540
3071,2010-08-05,17.4,105,295100,133,415800,-120700,216900,3835280
3072,2010-08-04,17.9,62,244200,66,166000,78200,131800,2198980
3073,2010-08-03,16.9,53,131500,75,216000,-84500,93600,1565390
3074,2010-08-02,16.9,39,89800,58,89400,400,49400,827380
3075,2010-07-30,16.8,49,77300,63,125400,-48100,54900,926420
3076,2010-07-29,17.0,44,87300,50,102900,-15600,45400,771690
3077,2010-07-28,16.4,59,146600,55,126400,20200,66100,1093970
3078,2010-07-27,16.9,86,162000,58,124600,37400,85800,1439190
3079,2010-07-26,16.5,90,115300,80,177800,-62500,88000,1456610
3080,2010-07-23,17.1,132,337300,61,183500,153800,134000,2262290
3081,2010-07-22,17.0,87,329000,45,175300,153700,85500,1482210
3082,2010-07-21,17.7,100,189100,82,205300,-16200,84800,1505620
3083,2010-07-20,18.3,88,129400,98,280100,-150700,93200,1712880
3084,2010-07-19,18.8,100,189300,153,378300,-189000,165200,3107610
3085,2010-07-16,18.7,103,191876,108,164050,27826,72980,1356554
3086,2010-07-15,18.5,93,177268,83,154450,22818,105530,1921701
3087,2010-07-14,20.0,2969,1607000,940,686600,920400,676700,12509620
3088,2010-07-13,18.3,51,40374,99,124110,-83736,29990,552122
3089,2010-07-12,18.2,73,91130,100,123651,-32521,48100,874276
3090,2010-07-09,18.0,94,169360,93,134370,34990,67400,1201730
3091,2010-07-08,17.6,71,102687,92,110120,-7433,49500,864320
3092,2010-07-07,17.9,70,138610,96,155060,-16450,73350,1295940
3093,2010-07-06,18.4,116,311280,153,336620,-25340,197610,3621554
3094,2010-07-05,19.6,202,455440,201,464420,-8980,346500,6697018
3095,2010-07-02,18.5,277,617462,212,460832,156630,460832,8465765
3096,2010-07-01,17.0,78,121261,76,219364,-98103,74151,1256072
3097,2010-06-30,16.6,77,107900,110,312919,-205019,79400,1334670
3098,2010-06-29,17.0,82,199117,122,295437,-96320,167827,2867280
3099,2010-06-28,17.2,101,185923,121,217740,-31817,110840,1910742
3100,2010-06-25,17.3,84,131452,119,213920,-82468,101431,1748914
3101,2010-06-24,17.7,206,341468,160,254920,86548,143310,2507888
3102,2010-06-23,16.8,197,229912,180,282541,-52629,125341,2109917
3103,2010-06-22,17.1,160,202100,153,238700,-36600,67066,1146829
3104,2010-06-21,17.6,123,174383,126,194915,-20532,85165,1496048
3105,2010-06-18,16.9,200,226921,138,209976,16945,147926,2493861
3106,2010-06-17,16.9,198,291682,156,234645,57037,134725,2265038
3107,2010-06-16,17.0,146,221172,129,214819,6353,73906,1255270
3108,2010-06-15,17.0,212,428970,248,538858,-109888,326183,5580420
3109,2010-06-14,16.5,232,435798,126,184748,251050,184748,3031941
3110,2010-06-11,15.1,333,611995,104,179117,432878,179117,2680468
3111,2010-06-10,14.0,89,147997,101,161837,-13840,76197,1050587
3112,2010-06-09,14.0,97,192764,101,202008,-9244,113398,1566748
3113,2010-06-08,14.0,106,184651,88,157591,27060,82891,1131486
3114,2010-06-07,13.3,69,114221,75,246836,-132615,49186,649245
3115,2010-06-04,13.7,125,113933,145,219213,-105280,72723,991217
3116,2010-06-03,13.7,69,89877,101,149763,-59886,54953,754180
3117,2010-06-02,13.8,70,90182,93,136310,-46128,37219,515080
3118,2010-06-01,13.9,73,122483,83,135999,-13516,37063,512667
3119,2010-05-31,13.7,92,142450,121,207630,-65180,59400,817366
3120,2010-05-28,13.9,137,212020,181,328625,-116605,157610,2210100
3121,2010-05-27,13.3,109,239482,118,241623,-2141,147233,1974110
3122,2010-05-26,13.1,55,47130,75,128701,-81571,12680,166350
3123,2010-05-25,12.6,55,94632,70,113262,-18630,28132,362413
3124,2010-05-24,13.0,85,187105,46,62417,124688,52135,675098
3125,2010-05-21,12.7,82,253123,108,271843,-18720,161433,2004305
3126,2010-05-20,13.5,104,235308,65,96148,139160,74948,1002911
3127,2010-05-19,12.6,83,166413,79,185320,-18907,103620,1286390
3128,2010-05-18,13.7,58,128750,118,279142,-150392,65640,880478
3129,2010-05-17,14.0,120,210330,129,261232,-50902,134230,1916244
3130,2010-05-14,13.5,158,397964,59,142830,255134,142830,1896985
3131,2010-05-13,13.0,182,603335,119,352365,250970,266835,3272070
3132,2010-05-12,12.8,108,303664,125,298584,5080,258954,3293391
3133,2010-05-11,14.0,124,249692,157,386962,-137270,247462,3438197
3134,2010-05-10,15.0,139,254391,183,399291,-144900,203061,3101718
3135,2010-05-07,15.2,93,278451,18,42600,235851,42600,647520
3136,2010-05-06,13.9,120,346704,26,50810,295894,50810,704859
3137,2010-05-05,12.7,121,296660,54,126230,170430,126230,1600256
3138,2010-05-04,11.9,126,396946,65,195398,201548,195398,2266446
3139,2010-04-29,11.3,102,275260,53,102508,172752,87260,950042
3140,2010-04-28,10.0,84,192010,87,208483,-16473,148890,1534795
3141,2010-04-27,10.0,48,69217,57,90659,-21442,31537,317269
3142,2010-04-26,10.1,33,75667,33,56522,19145,32922,341544
3143,2010-04-22,10.0,68,151020,44,81540,69480,56140,566600
3144,2010-04-21,10.3,84,97752,84,136030,-38278,91880,917618
3145,2010-04-20,10.5,65,66912,98,153685,-86773,56220,621101
3146,2010-04-19,11.6,142,241134,122,214030,27104,180630,2095941
3147,2010-04-16,10.7,120,257630,49,103370,154260,103370,1105479
3148,2010-04-15,10.3,87,247390,23,94290,153100,94290,927960
3149,2010-04-14,9.4,113,233430,49,78980,154450,78980,740672
3150,2010-04-13,9.1,98,222550,50,112800,109750,112800,975640
3151,2010-04-12,8.1,54,153700,55,145700,8000,118600,989950
3152,2010-04-09,8.2,30,75410,14,23800,51610,17100,137500
3153,2010-04-07,8.0,34,99110,45,114270,-15160,71160,578958
3154,2010-04-06,8.0,31,101350,24,80940,20410,72440,602350
3155,2010-04-05,7.9,13,35480,10,23740,11740,2000,15800
3156,2010-04-02,8.0,23,45710,16,19310,26400,5510,43488
3157,2010-04-01,8.0,15,31340,8,36200,-4860,0,0
3158,2010-03-31,7.9,22,44170,18,54600,-10430,23200,185100
3159,2010-03-30,7.6,31,91420,33,93520,-2100,65020,511726
3160,2010-03-29,7.6,15,53600,14,42600,11000,24900,189510
3161,2010-03-26,7.7,15,25870,16,64050,-38180,7050,55285
3162,2010-03-25,7.7,18,34150,19,33000,1150,10800,84210
3163,2010-03-24,8.0,17,34666,16,65535,-30869,22635,180117
3164,2010-03-23,7.9,18,24892,18,29417,-4525,9517,75759
3165,2010-03-22,8.0,25,76950,27,108310,-31360,56100,444290
3166,2010-03-19,8.1,23,35960,25,58030,-22070,20120,160717
3167,2010-03-18,7.8,25,39140,33,61200,-22060,12150,96580
3168,2010-03-17,7.9,28,39480,38,63800,-24320,32770,261947
3169,2010-03-16,8.0,13,19570,23,35770,-16200,1120,9459
3170,2010-03-15,8.0,36,85200,35,87800,-2600,33420,265994
3171,2010-03-12,7.9,19,44570,21,37890,6680,18680,149112
3172,2010-03-11,8.0,31,54250,30,57430,-3180,34200,272510
3173,2010-03-10,8.1,20,32540,20,40600,-8060,9600,76870
3174,2010-03-09,7.8,14,40870,23,40320,550,17130,133640
3175,2010-03-08,7.9,28,49790,39,61060,-11270,20900,164040
3176,2010-03-05,8.0,17,52850,32,63460,-10610,16400,130010
3177,2010-03-04,8.8,12,33910,24,29760,4150,12420,99616
3178,2010-03-03,8.1,26,30060,34,39980,-9920,17450,140013
3179,2010-03-02,7.8,31,44940,45,55170,-10230,32090,255744
3180,2010-03-01,8.2,21,43880,36,52670,-8790,25380,204583
3181,2010-02-26,8.1,25,59650,25,48560,11090,29600,236400
3182,2010-02-25,8.0,33,39960,39,67280,-27320,19380,154645
3183,2010-02-24,8.0,46,87785,40,68960,18825,46535,366807
3184,2010-02-23,7.8,23,1045370,19,1045490,-120,1027170,8011932
3185,2010-02-22,7.7,13,20120,18,27335,-7215,110,854
3186,2010-02-12,7.7,22,51770,19,49000,2770,15970,122569
3187,2010-02-11,7.8,18,50010,7,5370,44640,2010,15782
3188,2010-02-10,7.5,19,54420,14,30500,23920,1400,10540
3189,2010-02-09,7.5,24,54120,18,27810,26310,16100,121670
3190,2010-02-08,7.3,33,121775,32,144575,-22800,70475,522143
3191,2010-02-05,7.5,19,31860,30,66330,-34470,12530,96224
3192,2010-02-04,7.7,13,36630,28,85750,-49120,6400,51080
3193,2010-02-03,7.8,23,30100,41,66550,-36450,6000,48680
3194,2010-02-02,7.9,37,112020,48,116200,-4180,75370,614150
3195,2010-02-01,8.6,18,72800,25,89590,-16790,4000,33000
3196,2010-01-29,7.5,29,105050,39,124850,-19800,64050,508935
3197,2010-01-28,7.5,32,118200,35,112300,5900,51000,401240
3198,2010-01-27,8.1,8,10060,41,124330,-114270,10060,81234
3199,2010-01-26,8.3,21,50880,41,150100,-99220,41300,365210
3200,2010-01-25,8.1,8,28230,18,51400,-23170,200,1620
3201,2010-01-22,8.1,19,30780,22,55240,-24460,17400,140090
3202,2010-01-21,8.1,27,62350,37,115000,-52650,31500,267300
3203,2010-01-20,8.7,16,19450,35,60700,-41250,13300,113340
3204,2010-01-19,9.1,29,43950,37,57700,-13750,16900,151373
3205,2010-01-18,8.6,24,49000,36,65800,-16800,17800,155480
3206,2010-01-14,8.0,76,260710,21,52535,208175,52535,439702
3207,2010-01-13,7.8,21,38825,18,56525,-17700,26000,199500
3208,2010-01-12,7.5,22,26030,25,52210,-26180,19820,149575
3209,2010-01-11,8.0,10,26070,16,66880,-40810,24060,192484
3210,2010-01-08,7.7,27,73640,15,51475,22165,41340,317070
3211,2010-01-07,7.6,7,8670,6,5320,3350,3200,24620
3212,2010-01-06,7.8,26,29100,25,33040,-3940,17600,138400
3213,2010-01-05,8.0,11,13550,34,86120,-72570,13050,109560
3214,2010-01-04,9.2,54,151891,45,96000,55891,78500,683500
3215,2009-12-31,7.7,21,85900,34,99155,-13255,76900,648590
3216,2009-12-30,7.9,4,8100,12,28800,-20700,7000,56300
3217,2009-12-29,7.4,6,21000,16,33200,-12200,13000,96400
3218,2009-12-28,7.8,18,30100,19,31100,-1000,21100,160710
3219,2009-12-25,7.6,17,63800,23,73400,-9600,58300,440430
3220,2009-12-24,7.5,8,8020,10,12500,-4480,3500,26500
3221,2009-12-23,7.5,10,33500,15,42400,-8900,12000,90000
3222,2009-12-22,7.5,11,16380,16,19380,-3000,9880,74908
3223,2009-12-21,7.5,9,19320,30,47720,-28400,19220,144950
3224,2009-12-18,9.1,6,5100,36,49035,-43935,4100,34050
3225,2009-12-17,8.3,3,3500,15,17700,-14200,500,4150
3226,2009-12-16,7.6,10,12860,13,13800,-940,7200,54720
3227,2009-12-15,7.3,16,16910,21,21350,-4440,11750,88990
3228,2009-12-14,7.3,6,5520,8,9500,-3980,0,0
3229,2009-12-11,7.6,5,6000,12,14520,-8520,5000,36550
3230,2009-12-10,7.2,4,3500,24,24135,-20635,3500,26300
3231,2009-12-09,8.0,5,7600,9,21000,-13400,1500,12000
3232,2009-12-08,7.3,8,43650,7,38400,5250,30400,221920
3233,2009-12-07,7.7,6,17300,10,45100,-27800,8300,60880
3234,2009-12-04,7.9,6,15200,11,44700,-29500,1500,11650
3235,2009-12-03,7.8,39,74290,29,40170,34120,40170,308706
3236,2009-12-02,7.1,19,73450,13,38800,34650,34000,240385
3237,2009-12-01,7.3,19,43870,18,56170,-12300,12370,87856
3238,2009-11-30,7.3,14,34700,13,25200,9500,3700,26860
3239,2009-11-27,7.2,41,69390,23,66690,2700,25890,188903
3240,2009-11-26,7.9,11,31415,16,40615,-9200,31415,231578
3241,2009-11-25,7.6,10,18335,36,86435,-68100,18335,145686
3242,2009-11-24,8.2,10,12390,44,74520,-62130,7300,61560
3243,2009-11-23,8.2,19,50990,40,90480,-39490,36900,327710
3244,2009-11-20,8.9,9,39050,31,83530,-44480,3050,27645
3245,2009-11-19,9.4,15,67150,17,56040,11110,22500,206850
3246,2009-11-18,9.0,14,48800,23,75600,-26800,22100,190490
3247,2009-11-17,9.0,11,27520,15,64900,-37380,2000,18000
3248,2009-11-16,9.3,58,218550,30,100110,118440,100110,926823
3249,2009-11-13,8.9,41,94850,39,97020,-2170,70220,599672
3250,2009-11-12,8.7,18,77310,34,107310,-30000,55000,461380
3251,2009-11-11,8.2,10,20770,25,76600,-55830,9600,81690
3252,2009-11-10,9.0,16,43500,37,71780,-28280,37000,332240
3253,2009-11-09,8.8,12,23300,30,107470,-84170,17000,151400
3254,2009-11-06,8.9,23,71400,39,106730,-35330,39800,357180
3255,2009-11-05,9.0,11,18930,19,61400,-42470,15500,139500
3256,2009-11-04,9.0,7,12820,9,23420,-10600,20,180
3257,2009-11-03,8.6,35,55350,48,87100,-31750,52900,456040
3258,2009-11-02,9.5,6,10900,22,79020,-68120,10300,97560
3259,2009-10-30,9.7,23,29410,50,93880,-64470,29410,300879
3260,2009-10-29,10.5,14,30700,15,46360,-15660,6100,65250
3261,2009-10-27,9.4,35,78110,27,48000,30110,26700,242250
3262,2009-10-26,9.0,98,261460,72,155660,105800,116460,1029730
